,合约,日期,前收盘价,前结算价,开盘价,最高价,最低价,收盘价,结算价,涨跌1,涨跌2,成交量,成交金额,持仓量
1,a1601,20160104,3815,3826,3800,3870,3600,3800,3810,-26,-16,122,4649080,7072
2,a1601,20160105,3800,3810,3870,3870,3659,3800,3839,-10,29,50,1919580,6618
3,a1601,20160106,3800,3839,3636,3796,3609,3792,3785,-47,-54,290,10977640,6486
4,a1601,20160107,3792,3785,3790,3790,3786,3786,3788,1,3,182,6894200,6486
5,a1601,20160108,3786,3788,3780,3780,3780,3780,3780,-8,-8,16,604800,6084
6,a1601,20160111,3780,3780,3770,3788,3770,3788,3770,8,-10,54,2036160,5968
7,a1601,20160112,3788,3770,0,0,0,3770,3770,0,0,0,0,5918
8,a1601,20160113,3770,3770,0,0,0,3770,3770,0,0,0,0,5918
9,a1601,20160114,3770,3770,3750,3750,3750,3750,3750,-20,-20,2778,104175000,3226
10,a1601,20160115,3750,3750,3900,3900,3900,3900,3759,150,9,6,234000,0
11,a1603,20160104,3474,3482,3480,3484,3463,3463,3476,-19,-6,232,8066340,1182
12,a1603,20160105,3463,3476,3484,3485,3455,3483,3478,7,2,178,6191220,1192
13,a1603,20160106,3483,3478,3386,3480,3386,3463,3463,-15,-15,202,6995600,1212
14,a1603,20160107,3463,3463,3472,3488,3462,3469,3478,6,15,194,6749220,1250
15,a1603,20160108,3469,3478,3472,3493,3459,3489,3477,11,-1,318,11057080,1264
16,a1603,20160111,3489,3477,3489,3500,3460,3489,3483,12,6,260,9056360,1240
17,a1603,20160112,3489,3483,3493,3497,3483,3492,3489,9,6,78,2721480,1234
18,a1603,20160113,3492,3489,3493,3523,3493,3517,3510,28,21,216,7583020,1218
19,a1603,20160114,3517,3510,3514,3516,3492,3494,3498,-16,-12,88,3078980,1276
20,a1603,20160115,3494,3498,3499,3505,3492,3494,3499,-4,1,50,1749920,1278
21,a1603,20160118,3494,3499,3492,3505,3488,3503,3498,4,-1,58,2028840,1288
22,a1603,20160119,3503,3498,3498,3530,3498,3530,3516,32,18,88,3094400,1292
23,a1603,20160120,3530,3516,3607,3607,3498,3504,3520,-12,4,82,2886660,1298
24,a1603,20160121,3504,3520,3501,3505,3478,3497,3497,-23,-23,80,2797880,1302
25,a1603,20160122,3497,3497,3503,3517,3490,3505,3506,8,9,158,5539740,1290
26,a1603,20160125,3505,3506,3513,3525,3503,3503,3518,-3,12,100,3518660,1296
27,a1603,20160126,3503,3518,3499,3512,3499,3506,3504,-12,-14,18,630840,1298
28,a1603,20160127,3506,3504,3499,3507,3490,3492,3496,-12,-8,532,18602160,1702
29,a1603,20160128,3492,3496,3490,3493,3466,3466,3487,-30,-9,82,2859400,1720
30,a1603,20160129,3466,3487,3454,3459,3454,3459,3456,-28,-31,18,622120,1718
31,a1603,20160201,3459,3456,3455,3491,3448,3453,3458,-3,2,12,415040,1716
32,a1603,20160202,3453,3458,3445,3447,3382,3445,3430,-13,-28,22,754700,1716
33,a1603,20160203,3445,3430,3450,3450,3450,3450,3450,20,20,8,276000,1716
34,a1603,20160204,3450,3450,3429,3429,3400,3400,3412,-50,-38,42,1433400,1714
35,a1603,20160205,3400,3412,3409,3409,3350,3351,3373,-61,-39,14,472260,1718
36,a1603,20160215,3351,3373,3400,3400,3353,3353,3381,-20,8,6,202880,1716
37,a1603,20160216,3353,3381,3400,3400,3305,3400,3364,19,-17,16,538380,1718
38,a1603,20160217,3400,3364,3355,3371,3355,3360,3366,-4,2,60,2020000,1704
39,a1603,20160218,3360,3366,3375,3375,3344,3350,3356,-16,-10,178,5974020,1768
40,a1603,20160219,3350,3356,3359,3364,3334,3354,3352,-2,-4,12,402260,1768
41,a1603,20160222,3354,3352,3372,3397,3372,3397,3382,45,30,50,1691200,1778
42,a1603,20160223,3397,3382,3390,3390,3360,3390,3369,8,-13,46,1549940,1778
43,a1603,20160224,3390,3369,3392,3397,3355,3376,3383,7,14,240,8121420,1816
44,a1603,20160225,3376,3383,3381,3399,3350,3399,3382,16,-1,136,4600340,1720
45,a1603,20160226,3399,3382,3410,3410,3351,3377,3389,-5,7,78,2644180,1694
46,a1603,20160229,3377,3389,3400,3413,3390,3390,3401,1,12,174,5918900,1692
47,a1603,20160301,3390,3401,3199,3199,3199,3199,3199,-202,-202,4,127960,1686
48,a1603,20160302,3199,3199,3300,3300,3300,3300,3300,101,101,2,66000,1068
49,a1603,20160303,3300,3300,3498,3498,3498,3498,3498,198,198,2,69960,1068
50,a1603,20160304,3498,3498,3690,3690,3690,3690,3690,192,192,2,73800,0
51,a1603,20160307,3690,3690,0,0,0,3690,3690,0,0,0,0,0
52,a1603,20160308,3690,3690,0,0,0,3690,3690,0,0,0,0,0
53,a1603,20160309,3690,3690,0,0,0,3690,3690,0,0,0,0,0
54,a1603,20160310,3690,3690,0,0,0,3690,3690,0,0,0,0,0
55,a1603,20160311,3690,3690,0,0,0,3690,3690,0,0,0,0,0
56,a1603,20160314,3690,3690,0,0,0,3377,3377,-313,-313,0,0,0
57,a1605,20160104,3620,3615,3615,3645,3571,3603,3602,-12,-13,120894,4355167300,197206
58,a1605,20160105,3603,3602,3602,3624,3596,3614,3611,12,9,89338,3226227220,190302
59,a1605,20160106,3614,3611,3615,3620,3578,3596,3593,-15,-18,139100,4998695780,205446
60,a1605,20160107,3596,3593,3588,3630,3587,3596,3604,3,11,106460,3836827860,193450
61,a1605,20160108,3596,3604,3594,3620,3590,3607,3609,3,5,105130,3794465880,185866
62,a1605,20160111,3607,3609,3610,3616,3562,3578,3587,-31,-22,145006,5202112780,206616
63,a1605,20160112,3578,3587,3573,3589,3571,3582,3581,-5,-6,72774,2606162760,203610
64,a1605,20160113,3582,3581,3584,3619,3579,3613,3606,32,25,174728,6301766220,184960
65,a1605,20160114,3613,3606,3609,3611,3583,3590,3593,-16,-13,104958,3771708000,182756
66,a1605,20160115,3590,3593,3595,3600,3579,3590,3589,-3,-4,66458,2385496760,182734
67,a1605,20160118,3590,3589,3580,3614,3576,3601,3595,12,6,110376,3968845560,167490
68,a1605,20160119,3601,3595,3605,3645,3589,3636,3619,41,24,132664,4801374300,154624
69,a1605,20160120,3636,3619,3632,3648,3593,3603,3619,-16,0,109970,3980907440,154458
70,a1605,20160121,3603,3619,3613,3613,3570,3591,3586,-28,-33,126210,4526867180,163190
71,a1605,20160122,3591,3586,3593,3612,3586,3607,3601,21,15,88044,3170705960,161148
72,a1605,20160125,3607,3601,3610,3618,3576,3582,3594,-19,-7,99894,3590529660,171138
73,a1605,20160126,3582,3594,3581,3583,3541,3554,3552,-40,-42,190252,6757911000,202950
74,a1605,20160127,3554,3552,3556,3574,3534,3564,3557,12,5,137268,4882823200,183362
75,a1605,20160128,3564,3557,3570,3570,3523,3529,3545,-28,-12,139930,4961576400,196934
76,a1605,20160129,3529,3545,3528,3534,3507,3516,3522,-29,-23,121634,4284311080,197610
77,a1605,20160201,3516,3522,3515,3533,3512,3517,3521,-5,-1,59240,2086156460,195640
78,a1605,20160202,3517,3521,3515,3515,3484,3508,3506,-13,-15,91506,3208455100,203898
79,a1605,20160203,3508,3506,3508,3528,3504,3516,3517,10,11,78004,2743740720,190534
80,a1605,20160204,3516,3517,3515,3516,3471,3487,3487,-30,-30,122216,4262822400,192058
81,a1605,20160205,3487,3487,3486,3491,3453,3479,3473,-8,-14,104962,3645762100,172868
82,a1605,20160215,3479,3473,3465,3487,3426,3453,3451,-20,-22,75086,2591707620,183188
83,a1605,20160216,3453,3451,3456,3474,3450,3462,3462,11,11,74264,2571735440,181606
84,a1605,20160217,3462,3462,3461,3483,3454,3480,3467,18,5,86988,3016676800,177846
85,a1605,20160218,3480,3467,3478,3488,3471,3481,3478,14,11,65616,2282744400,176676
86,a1605,20160219,3481,3478,3480,3500,3474,3491,3488,13,10,75744,2642616240,174278
87,a1605,20160222,3491,3488,3493,3557,3487,3542,3520,54,32,128196,4512732500,149568
88,a1605,20160223,3542,3520,3540,3552,3508,3538,3526,18,6,77424,2730257000,142230
89,a1605,20160224,3538,3526,3535,3542,3504,3518,3520,-8,-6,75512,2658348900,143046
90,a1605,20160225,3518,3520,3518,3526,3502,3508,3516,-12,-4,70366,2474489520,142886
91,a1605,20160226,3508,3516,3508,3548,3508,3531,3529,15,13,114558,4043373240,138276
92,a1605,20160229,3531,3529,3528,3541,3463,3510,3501,-19,-28,127406,4460856380,130936
93,a1605,20160301,3510,3501,3506,3534,3506,3527,3519,26,18,70380,2477160620,127112
94,a1605,20160302,3527,3519,3523,3568,3506,3548,3535,29,16,127890,4522123880,119344
95,a1605,20160303,3548,3535,3545,3638,3542,3624,3604,89,69,210756,7597411800,125378
96,a1605,20160304,3624,3604,3624,3645,3606,3639,3626,35,22,136004,4932189600,121360
97,a1605,20160307,3639,3626,3638,3688,3583,3601,3636,-25,10,198926,7234629260,102388
98,a1605,20160308,3601,3636,3605,3636,3579,3592,3606,-44,-30,111296,4013917060,91930
99,a1605,20160309,3592,3606,3599,3614,3555,3580,3583,-26,-23,105340,3774680800,84250
100,a1605,20160310,3580,3583,3584,3606,3565,3565,3582,-18,-1,86770,3108370820,80792
101,a1605,20160311,3565,3582,3570,3577,3525,3549,3555,-33,-27,84168,2992195200,79420
102,a1605,20160314,3549,3555,3552,3573,3530,3533,3553,-22,-2,57664,2048965920,73294
103,a1605,20160315,3533,3553,3535,3548,3473,3476,3508,-77,-45,80356,2819586580,66158
104,a1605,20160316,3476,3508,3482,3485,3425,3445,3457,-63,-51,48716,1684587840,68896
105,a1605,20160317,3445,3457,3435,3461,3432,3456,3449,-1,-8,42088,1451908160,61978
106,a1605,20160318,3456,3449,3453,3465,3419,3438,3443,-11,-6,69524,2394393200,55006
107,a1605,20160321,3438,3443,3441,3448,3423,3425,3433,-18,-10,20838,715529940,51748
108,a1605,20160322,3425,3433,3426,3458,3426,3452,3448,19,15,23610,814110400,48844
109,a1605,20160323,3452,3448,3447,3478,3429,3446,3453,-2,5,30052,1037696780,43300
110,a1605,20160324,3446,3453,3440,3463,3435,3443,3448,-10,-5,19918,686863660,41290
111,a1605,20160325,3443,3448,3441,3468,3437,3456,3454,8,6,13510,466730440,39384
112,a1605,20160328,3456,3454,3465,3465,3445,3445,3454,-9,0,12832,443281040,35618
113,a1605,20160329,3445,3454,3447,3459,3426,3430,3441,-24,-13,9024,310555760,34586
114,a1605,20160330,3430,3441,3449,3450,3430,3444,3442,3,1,6066,208801500,33084
115,a1605,20160331,3444,3442,3440,3449,3405,3414,3418,-28,-24,8758,299410600,31084
116,a1605,20160401,3414,3418,3420,3427,3341,3345,3383,-73,-35,22264,753388940,26934
117,a1605,20160405,3345,3383,3349,3355,3333,3343,3346,-40,-37,5060,169315040,25946
118,a1605,20160406,3343,3346,3338,3344,3281,3284,3306,-62,-40,9054,299400520,24358
119,a1605,20160407,3284,3306,3282,3306,3276,3279,3291,-27,-15,6020,198159060,24298
120,a1605,20160408,3279,3291,3285,3311,3276,3297,3295,6,4,5404,178112000,22648
121,a1605,20160411,3297,3295,3297,3336,3296,3323,3317,28,22,5186,172049420,21608
122,a1605,20160412,3323,3317,3336,3345,3312,3342,3333,25,16,2700,90001860,20410
123,a1605,20160413,3342,3333,3345,3399,3345,3385,3380,52,47,6454,218148980,17972
124,a1605,20160414,3385,3380,3385,3403,3373,3375,3391,-5,11,4204,142586200,17262
125,a1605,20160415,3375,3391,3376,3385,3350,3350,3366,-41,-25,3774,127052960,16034
126,a1605,20160418,3350,3366,3336,3401,3330,3386,3379,20,13,3666,123904620,14666
127,a1605,20160419,3386,3379,3392,3413,3377,3388,3394,9,15,4388,148962580,12642
128,a1605,20160420,3388,3394,3393,3520,3391,3494,3468,100,74,8068,279848060,8338
129,a1605,20160421,3494,3468,3488,3606,3474,3606,3566,138,98,4948,176479160,6936
130,a1605,20160422,3606,3566,3620,3734,3480,3547,3633,-19,67,7054,256315500,4752
131,a1605,20160425,3547,3633,3547,3723,3540,3600,3610,-33,-23,1750,63179120,4310
132,a1605,20160426,3600,3610,3620,3630,3567,3605,3605,-5,-5,838,30217500,4162
133,a1605,20160427,3605,3605,3605,3645,3575,3576,3592,-29,-13,1944,69830600,2848
134,a1605,20160428,3576,3592,3610,3610,3497,3510,3524,-82,-68,620,21850260,2488
135,a1605,20160429,3510,3524,3510,3553,3431,3431,3492,-93,-32,2044,71380520,2168
136,a1605,20160503,3431,3492,3520,3630,3520,3630,3588,138,96,984,35311500,1678
137,a1605,20160504,3630,3588,0,0,0,3588,3588,0,0,0,0,1678
138,a1605,20160505,3588,3588,0,0,0,3588,3588,0,0,0,0,1678
139,a1605,20160506,3588,3588,0,0,0,3588,3588,0,0,0,0,1678
140,a1605,20160509,3588,3588,0,0,0,3588,3588,0,0,0,0,878
141,a1605,20160510,3588,3588,0,0,0,3588,3588,0,0,0,0,878
142,a1605,20160511,3588,3588,0,0,0,3588,3588,0,0,0,0,878
143,a1605,20160512,3588,3588,0,0,0,3588,3588,0,0,0,0,878
144,a1605,20160513,3588,3588,0,0,0,3588,3588,0,0,0,0,878
145,a1605,20160516,3588,3588,3700,3700,3700,3700,3617,112,29,340,12580000,0
146,a1607,20160104,3596,3596,0,0,0,3584,3584,-12,-12,0,0,10
147,a1607,20160105,3584,3584,0,0,0,3592,3592,8,8,0,0,10
148,a1607,20160106,3592,3592,0,0,0,3575,3575,-17,-17,0,0,10
149,a1607,20160107,3575,3575,0,0,0,3585,3585,10,10,0,0,10
150,a1607,20160108,3585,3585,0,0,0,3585,3585,0,0,0,0,10
151,a1607,20160111,3585,3585,3639,3639,3583,3583,3611,-2,26,4,144440,10
152,a1607,20160112,3583,3611,0,0,0,3605,3605,-6,-6,0,0,10
153,a1607,20160113,3605,3605,3661,3668,3600,3668,3643,63,38,6,218580,12
154,a1607,20160114,3668,3643,3578,3578,3578,3578,3578,-65,-65,2,71560,10
155,a1607,20160115,3578,3578,3616,3616,3616,3616,3616,38,38,2,72320,10
156,a1607,20160118,3616,3616,0,0,0,3616,3616,0,0,0,0,10
157,a1607,20160119,3616,3616,0,0,0,3616,3616,0,0,0,0,10
158,a1607,20160120,3616,3616,0,0,0,3616,3616,0,0,0,0,10
159,a1607,20160121,3616,3616,3615,3615,3615,3615,3615,-1,-1,2,72300,10
160,a1607,20160122,3615,3615,0,0,0,3630,3630,15,15,0,0,10
161,a1607,20160125,3630,3630,0,0,0,3630,3630,0,0,0,0,10
162,a1607,20160126,3630,3630,3489,3614,3489,3614,3542,-16,-88,12,425040,14
163,a1607,20160127,3614,3542,0,0,0,3571,3571,29,29,0,0,14
164,a1607,20160128,3571,3571,0,0,0,3570,3570,-1,-1,0,0,14
165,a1607,20160129,3570,3570,3480,3570,3480,3510,3529,-60,-41,8,282340,14
166,a1607,20160201,3510,3529,3536,3536,3536,3536,3536,7,7,4,141440,10
167,a1607,20160202,3536,3536,0,0,0,3533,3533,-3,-3,0,0,10
168,a1607,20160203,3533,3533,0,0,0,3533,3533,0,0,0,0,10
169,a1607,20160204,3533,3533,0,0,0,3523,3523,-10,-10,0,0,10
170,a1607,20160205,3523,3523,0,0,0,3509,3509,-14,-14,0,0,10
171,a1607,20160215,3509,3509,0,0,0,3495,3495,-14,-14,0,0,10
172,a1607,20160216,3495,3495,0,0,0,3495,3495,0,0,0,0,10
173,a1607,20160217,3495,3495,0,0,0,3500,3500,5,5,0,0,10
174,a1607,20160218,3500,3500,0,0,0,3500,3500,0,0,0,0,10
175,a1607,20160219,3500,3500,0,0,0,3510,3510,10,10,0,0,10
176,a1607,20160222,3510,3510,3554,3554,3495,3495,3535,-15,25,22,777700,10
177,a1607,20160223,3495,3535,0,0,0,3535,3535,0,0,0,0,10
178,a1607,20160224,3535,3535,0,0,0,3535,3535,0,0,0,0,10
179,a1607,20160225,3535,3535,0,0,0,3515,3515,-20,-20,0,0,10
180,a1607,20160226,3515,3515,0,0,0,3515,3515,0,0,0,0,10
181,a1607,20160229,3515,3515,0,0,0,3510,3510,-5,-5,0,0,10
182,a1607,20160301,3510,3510,3492,3523,3492,3520,3509,10,-1,10,350940,18
183,a1607,20160302,3520,3509,3522,3522,3521,3521,3521,12,12,4,140860,14
184,a1607,20160303,3521,3521,3559,3559,3559,3559,3559,38,38,2,71180,14
185,a1607,20160304,3559,3559,0,0,0,3619,3619,60,60,0,0,14
186,a1607,20160307,3619,3619,3649,3658,3557,3658,3616,39,-3,10,361600,14
187,a1607,20160308,3658,3616,0,0,0,3616,3616,0,0,0,0,14
188,a1607,20160309,3616,3616,0,0,0,3593,3593,-23,-23,0,0,14
189,a1607,20160310,3593,3593,3637,3637,3613,3613,3621,20,28,6,217280,10
190,a1607,20160311,3613,3621,0,0,0,3590,3590,-31,-31,0,0,10
191,a1607,20160314,3590,3590,0,0,0,3588,3588,-2,-2,0,0,10
192,a1607,20160315,3588,3588,3544,3544,3544,3544,3544,-44,-44,6,212640,16
193,a1607,20160316,3544,3544,0,0,0,3544,3544,0,0,0,0,16
194,a1607,20160317,3544,3544,0,0,0,3536,3536,-8,-8,0,0,16
195,a1607,20160318,3536,3536,3527,3527,3499,3510,3513,-26,-23,10,351300,16
196,a1607,20160321,3510,3513,3523,3523,3523,3523,3523,10,10,2,70460,18
197,a1607,20160322,3523,3523,3521,3556,3500,3501,3525,-22,2,18,634640,16
198,a1607,20160323,3501,3525,0,0,0,3530,3530,5,5,0,0,16
199,a1607,20160324,3530,3530,3529,3539,3448,3506,3506,-24,-24,26,911780,22
200,a1607,20160325,3506,3506,3550,3550,3501,3501,3525,-5,19,4,141020,22
201,a1607,20160328,3501,3525,0,0,0,3525,3525,0,0,0,0,22
202,a1607,20160329,3525,3525,3468,3468,3468,3468,3468,-57,-57,8,277440,16
203,a1607,20160330,3468,3468,0,0,0,3468,3468,0,0,0,0,16
204,a1607,20160331,3468,3468,0,0,0,3444,3444,-24,-24,0,0,16
205,a1607,20160401,3444,3444,0,0,0,3409,3409,-35,-35,0,0,16
206,a1607,20160405,3409,3409,0,0,0,3409,3409,0,0,0,0,16
207,a1607,20160406,3409,3409,0,0,0,3369,3369,-40,-40,0,0,16
208,a1607,20160407,3369,3369,0,0,0,3368,3368,-1,-1,0,0,16
209,a1607,20160408,3368,3368,3355,3355,3355,3355,3355,-13,-13,2,67100,18
210,a1607,20160411,3355,3355,3355,3355,3355,3355,3355,0,0,2,67100,18
211,a1607,20160412,3355,3355,3415,3415,3288,3302,3342,-53,-13,12,401080,20
212,a1607,20160413,3302,3342,3370,3449,3370,3449,3409,107,67,4,136380,18
213,a1607,20160414,3449,3409,0,0,0,3420,3420,11,11,0,0,18
214,a1607,20160415,3420,3420,3444,3472,3346,3400,3391,-20,-29,14,474760,18
215,a1607,20160418,3400,3391,0,0,0,3391,3391,0,0,0,0,18
216,a1607,20160419,3391,3391,3505,3505,3441,3449,3465,58,74,6,207900,20
217,a1607,20160420,3449,3465,0,0,0,3540,3540,75,75,0,0,20
218,a1607,20160421,3540,3540,3592,3681,3592,3618,3643,78,103,8,291440,20
219,a1607,20160422,3618,3643,3604,3738,3604,3738,3681,95,38,10,368180,20
220,a1607,20160425,3738,3681,3681,3736,3660,3660,3704,-21,23,14,518560,20
221,a1607,20160426,3660,3704,3690,3690,3690,3690,3690,-14,-14,2,73800,20
222,a1607,20160427,3690,3690,0,0,0,3690,3690,0,0,0,0,20
223,a1607,20160428,3690,3690,3661,3661,3507,3512,3608,-178,-82,36,1298880,42
224,a1607,20160429,3512,3608,3535,3535,3534,3534,3534,-74,-74,6,212060,42
225,a1607,20160503,3534,3534,3535,3609,3535,3600,3552,66,18,28,994780,42
226,a1607,20160504,3600,3552,0,0,0,3552,3552,0,0,0,0,42
227,a1607,20160505,3552,3552,3552,3552,3540,3540,3546,-12,-6,4,141840,42
228,a1607,20160506,3540,3546,0,0,0,3546,3546,0,0,0,0,42
229,a1607,20160509,3546,3546,3508,3567,3406,3545,3504,-1,-42,54,1892600,74
230,a1607,20160510,3545,3504,3506,3555,3506,3555,3528,51,24,60,2117100,68
231,a1607,20160511,3555,3528,3560,3695,3560,3683,3616,155,88,70,2531880,62
232,a1607,20160512,3683,3616,3629,3660,3580,3660,3639,44,23,42,1528460,74
233,a1607,20160513,3660,3639,3620,3629,3532,3532,3601,-107,-38,34,1224460,50
234,a1607,20160516,3532,3601,3632,3632,3463,3575,3556,-26,-45,6,213400,50
235,a1607,20160517,3575,3556,3591,3620,3591,3602,3610,46,54,14,505420,48
236,a1607,20160518,3602,3610,3660,3660,3660,3660,3660,50,50,2,73200,46
237,a1607,20160519,3660,3660,0,0,0,3664,3664,4,4,0,0,46
238,a1607,20160520,3664,3664,3697,3697,3660,3660,3671,-4,7,16,587500,44
239,a1607,20160523,3660,3671,3675,3675,3650,3650,3664,-21,-7,12,439700,56
240,a1607,20160524,3650,3664,3601,3646,3565,3565,3607,-99,-57,8,288620,56
241,a1607,20160525,3565,3607,3640,3640,3614,3614,3623,7,16,6,217380,52
242,a1607,20160526,3614,3623,3620,3680,3610,3615,3619,-8,-4,30,1085720,42
243,a1607,20160527,3615,3619,3645,3649,3605,3622,3627,3,8,36,1305820,42
244,a1607,20160530,3622,3627,3674,3680,3645,3680,3661,53,34,30,1098540,42
245,a1607,20160531,3680,3661,3680,3700,3671,3674,3681,13,20,8,294500,42
246,a1607,20160601,3674,3681,3731,3731,3641,3675,3676,-6,-5,12,441200,48
247,a1607,20160602,3675,3676,3686,3777,3686,3706,3716,30,40,24,891880,50
248,a1607,20160603,3706,3716,3809,3809,3809,3809,3809,93,93,2,76180,50
249,a1607,20160606,3809,3809,3815,3816,3806,3806,3812,-3,3,18,686320,46
250,a1607,20160607,3806,3812,3786,3845,3786,3801,3817,-11,5,70,2672440,44
251,a1607,20160608,3801,3817,3800,3800,3800,3800,3800,-17,-17,2,76000,44
252,a1607,20160613,3800,3800,0,0,0,3900,3900,100,100,0,0,44
253,a1607,20160614,3900,3900,3900,3930,3807,3860,3874,-40,-26,16,619840,44
254,a1607,20160615,3860,3874,0,0,0,3874,3874,0,0,0,0,44
255,a1607,20160616,3874,3874,3791,3791,3791,3791,3791,-83,-83,2,75820,46
256,a1607,20160617,3791,3791,3681,3896,3681,3779,3797,-12,6,58,2202400,52
257,a1607,20160620,3779,3797,3871,3871,3800,3860,3841,63,44,12,460960,48
258,a1607,20160621,3860,3841,3837,3900,3837,3850,3854,9,13,20,770920,58
259,a1607,20160622,3850,3854,0,0,0,3849,3849,-5,-5,0,0,58
260,a1607,20160623,3849,3849,3856,3866,3856,3856,3858,7,9,8,308700,56
261,a1607,20160624,3856,3858,3849,3903,3837,3837,3868,-21,10,12,464180,56
262,a1607,20160627,3837,3868,0,0,0,3868,3868,0,0,0,0,56
263,a1607,20160628,3868,3868,3926,3926,3926,3926,3926,58,58,4,157040,56
264,a1607,20160629,3926,3926,3869,3970,3815,3905,3887,-21,-39,40,1555040,54
265,a1607,20160630,3905,3887,3950,4070,3905,4000,3985,113,98,10,398520,50
266,a1607,20160701,4000,3985,3900,3900,3900,3900,3900,-85,-85,2,78000,50
267,a1607,20160704,3900,3900,0,0,0,3900,3900,0,0,0,0,12
268,a1607,20160705,3900,3900,0,0,0,3900,3900,0,0,0,0,12
269,a1607,20160706,3900,3900,0,0,0,3900,3900,0,0,0,0,0
270,a1607,20160707,3900,3900,0,0,0,3900,3900,0,0,0,0,0
271,a1607,20160708,3900,3900,0,0,0,3900,3900,0,0,0,0,0
272,a1607,20160711,3900,3900,0,0,0,3900,3900,0,0,0,0,0
273,a1607,20160712,3900,3900,0,0,0,3900,3900,0,0,0,0,0
274,a1607,20160713,3900,3900,0,0,0,3900,3900,0,0,0,0,0
275,a1607,20160714,3900,3900,0,0,0,3900,3900,0,0,0,0,0
276,a1609,20160104,3528,3527,3518,3557,3485,3514,3516,-13,-11,9854,346509020,39548
277,a1609,20160105,3514,3516,3513,3526,3505,3518,3516,2,0,9858,346680500,39960
278,a1609,20160106,3518,3516,3520,3523,3474,3483,3490,-33,-26,27336,954169260,51278
279,a1609,20160107,3483,3490,3486,3512,3477,3492,3494,2,4,13846,483820240,51814
280,a1609,20160108,3492,3494,3490,3517,3485,3506,3505,12,11,13514,473726620,50554
281,a1609,20160111,3506,3505,3509,3511,3480,3487,3494,-18,-11,13330,465823740,52552
282,a1609,20160112,3487,3494,3487,3501,3482,3485,3490,-9,-4,10940,381832900,53366
283,a1609,20160113,3485,3490,3485,3514,3485,3504,3503,14,13,15900,557026780,53248
284,a1609,20160114,3504,3503,3510,3510,3489,3493,3493,-10,-10,9288,324494540,53756
285,a1609,20160115,3493,3493,3495,3498,3484,3487,3490,-6,-3,8272,288742420,54334
286,a1609,20160118,3487,3490,3481,3509,3470,3500,3491,10,1,18042,630007400,53090
287,a1609,20160119,3500,3491,3507,3541,3491,3536,3519,45,28,16498,580690820,48296
288,a1609,20160120,3536,3519,3534,3549,3506,3511,3527,-8,8,15212,536539340,47686
289,a1609,20160121,3511,3527,3510,3521,3501,3507,3510,-20,-17,8640,303269340,46826
290,a1609,20160122,3507,3510,3502,3528,3502,3522,3519,12,9,8698,306134620,46306
291,a1609,20160125,3522,3519,3524,3531,3506,3510,3518,-9,-1,9526,335151780,46920
292,a1609,20160126,3510,3518,3511,3511,3484,3491,3491,-27,-27,15188,530339380,50638
293,a1609,20160127,3491,3491,3491,3496,3476,3487,3484,-4,-7,19058,664046720,57636
294,a1609,20160128,3487,3484,3489,3489,3453,3456,3469,-28,-15,24116,836599500,69516
295,a1609,20160129,3456,3469,3454,3468,3447,3453,3457,-16,-12,14984,518030200,67008
296,a1609,20160201,3453,3457,3457,3467,3453,3456,3458,-1,1,5370,185745960,66666
297,a1609,20160202,3456,3458,3453,3461,3437,3457,3453,-1,-5,8136,280937420,64670
298,a1609,20160203,3457,3453,3451,3468,3451,3457,3457,4,4,7806,269858960,65230
299,a1609,20160204,3457,3457,3457,3466,3419,3431,3435,-26,-22,22970,789064440,67246
300,a1609,20160205,3431,3435,3433,3433,3396,3406,3409,-29,-26,19126,652116400,73318
301,a1609,20160215,3406,3409,3405,3429,3371,3384,3400,-25,-9,14520,493770620,76598
302,a1609,20160216,3384,3400,3390,3413,3389,3403,3403,3,3,16716,568949200,76534
303,a1609,20160217,3403,3403,3409,3409,3392,3405,3401,2,-2,13324,453213460,76848
304,a1609,20160218,3405,3401,3405,3409,3392,3394,3399,-7,-2,13940,473934720,80874
305,a1609,20160219,3394,3399,3395,3405,3383,3400,3398,1,-1,10392,353177460,80472
306,a1609,20160222,3400,3398,3395,3446,3395,3438,3422,40,24,28382,971376520,75692
307,a1609,20160223,3438,3422,3446,3447,3421,3437,3432,15,10,17332,594956740,75490
308,a1609,20160224,3437,3432,3434,3443,3409,3416,3422,-16,-10,21420,733022140,77056
309,a1609,20160225,3416,3422,3410,3426,3404,3409,3416,-13,-6,14218,485819580,78662
310,a1609,20160226,3409,3416,3411,3435,3408,3417,3420,1,4,24686,844294340,78698
311,a1609,20160229,3417,3420,3418,3433,3355,3384,3385,-36,-35,37316,1263468760,87256
312,a1609,20160301,3384,3385,3386,3415,3384,3402,3397,17,12,24300,825584260,84780
313,a1609,20160302,3402,3397,3404,3450,3402,3437,3432,40,35,40898,1403934720,80540
314,a1609,20160303,3437,3432,3433,3496,3427,3480,3469,48,37,76562,2656068540,91456
315,a1609,20160304,3480,3469,3479,3517,3465,3509,3488,40,19,47160,1645393120,90674
316,a1609,20160307,3509,3488,3510,3550,3470,3486,3510,-2,22,83024,2914239820,95344
317,a1609,20160308,3486,3510,3490,3522,3466,3489,3493,-21,-17,73396,2564099300,99916
318,a1609,20160309,3489,3493,3493,3506,3462,3471,3480,-22,-13,94680,3295690020,123362
319,a1609,20160310,3471,3480,3492,3492,3460,3470,3477,-10,-3,67600,2350589240,130172
320,a1609,20160311,3470,3477,3474,3474,3432,3451,3449,-26,-28,61028,2105307020,133102
321,a1609,20160314,3451,3449,3455,3469,3437,3444,3452,-5,3,64536,2227919740,141346
322,a1609,20160315,3444,3452,3442,3455,3397,3402,3420,-50,-32,135894,4647682260,160232
323,a1609,20160316,3402,3420,3402,3411,3360,3376,3383,-44,-37,143460,4853358780,176546
324,a1609,20160317,3376,3383,3379,3397,3368,3390,3384,7,1,131850,4462635520,171994
325,a1609,20160318,3390,3384,3400,3470,3393,3441,3429,57,45,213280,7314397500,157616
326,a1609,20160321,3441,3429,3440,3454,3407,3422,3430,-7,1,106310,3647448560,165054
327,a1609,20160322,3422,3430,3427,3506,3423,3491,3478,61,48,211886,7369629840,167896
328,a1609,20160323,3491,3478,3488,3540,3475,3480,3512,2,34,229932,8075669500,165874
329,a1609,20160324,3480,3512,3473,3512,3444,3470,3485,-42,-27,232162,8092726980,168568
330,a1609,20160325,3470,3485,3465,3529,3449,3513,3506,28,21,217458,7624123020,169684
331,a1609,20160328,3513,3506,3515,3532,3475,3478,3508,-28,2,207304,7273551220,165356
332,a1609,20160329,3478,3508,3480,3494,3452,3456,3472,-52,-36,172644,5995801980,162812
333,a1609,20160330,3456,3472,3465,3489,3457,3475,3474,3,2,163620,5685041940,170128
334,a1609,20160331,3475,3474,3475,3483,3429,3447,3451,-27,-23,160736,5548103980,156680
335,a1609,20160401,3447,3451,3452,3452,3373,3379,3405,-72,-46,275376,9377056300,197508
336,a1609,20160405,3379,3405,3385,3399,3364,3372,3381,-33,-24,155400,5255273260,215080
337,a1609,20160406,3372,3381,3370,3370,3316,3322,3335,-59,-46,301268,10049910740,254364
338,a1609,20160407,3322,3335,3315,3340,3310,3322,3329,-13,-6,172132,5730556540,263620
339,a1609,20160408,3322,3329,3322,3335,3312,3318,3322,-11,-7,168082,5584096520,266886
340,a1609,20160411,3318,3322,3322,3367,3316,3339,3345,17,23,229192,7666631280,259360
341,a1609,20160412,3339,3345,3340,3374,3338,3369,3357,24,12,182198,6118003000,254734
342,a1609,20160413,3369,3357,3372,3448,3370,3416,3413,59,56,364814,12452782620,228406
343,a1609,20160414,3416,3413,3410,3479,3410,3444,3448,31,35,286900,9893740200,229698
344,a1609,20160415,3444,3448,3443,3464,3421,3422,3442,-26,-6,216066,7438802680,230192
345,a1609,20160418,3422,3442,3418,3498,3408,3476,3463,34,21,315794,10938170980,243730
346,a1609,20160419,3476,3463,3481,3510,3466,3483,3486,20,23,303814,10592932400,243244
347,a1609,20160420,3483,3486,3498,3625,3490,3611,3580,125,94,687638,24621906460,254672
348,a1609,20160421,3611,3580,3610,3723,3583,3723,3651,143,71,358134,13078622540,255156
349,a1609,20160422,3723,3651,3796,3869,3601,3681,3762,30,111,1299000,48877187420,259052
350,a1609,20160425,3681,3762,3695,3855,3660,3702,3739,-60,-23,1019412,38124564640,289762
351,a1609,20160426,3702,3739,3701,3765,3672,3707,3720,-32,-19,561860,20902953860,263562
352,a1609,20160427,3707,3720,3723,3743,3664,3683,3698,-37,-22,447228,16541167320,265726
353,a1609,20160428,3683,3698,3687,3695,3574,3600,3630,-98,-68,476878,17311163640,245536
354,a1609,20160429,3600,3630,3602,3657,3581,3586,3621,-44,-9,341034,12349839580,249736
355,a1609,20160503,3586,3621,3620,3708,3595,3704,3662,83,41,314320,11510668880,261846
356,a1609,20160504,3704,3662,3691,3731,3616,3631,3661,-31,-1,350268,12824359980,260188
357,a1609,20160505,3631,3661,3631,3655,3597,3610,3629,-51,-32,266052,9655049880,275140
358,a1609,20160506,3610,3629,3636,3645,3500,3520,3556,-109,-73,382470,13601005960,269000
359,a1609,20160509,3520,3556,3521,3579,3493,3530,3531,-26,-25,420272,14843797380,276116
360,a1609,20160510,3530,3531,3521,3536,3462,3508,3493,-23,-38,296648,10364352740,272958
361,a1609,20160511,3508,3493,3514,3667,3506,3667,3618,174,125,553812,20040579100,313318
362,a1609,20160512,3667,3618,3660,3723,3607,3645,3660,27,42,781138,28593509600,296964
363,a1609,20160513,3645,3660,3645,3676,3530,3567,3596,-93,-64,561366,20191268720,264922
364,a1609,20160516,3567,3596,3568,3642,3545,3614,3598,18,2,372828,13416700600,263680
365,a1609,20160517,3614,3598,3610,3678,3609,3676,3648,78,50,337004,12296813860,260614
366,a1609,20160518,3676,3648,3680,3780,3658,3689,3719,41,71,560494,20850220420,233280
367,a1609,20160519,3689,3719,3691,3753,3652,3742,3720,23,1,639040,23777426000,242624
368,a1609,20160520,3742,3720,3722,3734,3680,3721,3710,1,-10,346946,12872426500,242742
369,a1609,20160523,3721,3710,3753,3770,3640,3653,3690,-57,-20,388680,14344992360,228750
370,a1609,20160524,3653,3690,3654,3664,3518,3537,3583,-153,-107,441674,15827110500,216454
371,a1609,20160525,3537,3583,3538,3588,3512,3569,3557,-14,-26,302886,10774400760,204502
372,a1609,20160526,3569,3557,3575,3669,3575,3661,3628,104,71,345342,12529871000,203086
373,a1609,20160527,3661,3628,3671,3693,3605,3661,3645,33,17,313538,11431293200,205980
374,a1609,20160530,3661,3645,3655,3755,3646,3720,3707,75,62,324160,12017498540,212546
375,a1609,20160531,3720,3707,3670,3763,3620,3717,3700,10,-7,460928,17055139560,230640
376,a1609,20160601,3717,3700,3740,3808,3668,3713,3745,13,45,663104,24838346220,216136
377,a1609,20160602,3713,3745,3720,3806,3691,3766,3763,21,18,448598,16881732720,233346
378,a1609,20160603,3766,3763,3773,3837,3762,3833,3802,70,39,439744,16723245120,236826
379,a1609,20160606,3833,3802,3855,3865,3783,3830,3817,28,15,344744,13162234760,229904
380,a1609,20160607,3830,3817,3839,3849,3798,3831,3820,14,3,322764,12329750000,231216
381,a1609,20160608,3831,3820,3821,3840,3770,3826,3806,6,-14,343748,13086190860,226418
382,a1609,20160613,3826,3806,3898,3992,3898,3944,3952,138,146,290542,11483995900,239896
383,a1609,20160614,3944,3952,3950,3971,3844,3879,3910,-73,-42,344664,13477285580,234960
384,a1609,20160615,3879,3910,3892,3905,3834,3868,3867,-42,-43,263608,10194202080,231304
385,a1609,20160616,3868,3867,3884,3907,3798,3813,3853,-54,-14,276188,10641977120,224584
386,a1609,20160617,3813,3853,3817,3849,3767,3848,3813,-5,-40,213086,8126798080,218630
387,a1609,20160620,3848,3813,3860,3875,3803,3847,3841,34,28,194354,7465568360,214246
388,a1609,20160621,3847,3841,3837,3892,3818,3849,3857,8,16,201912,7789657620,210650
389,a1609,20160622,3849,3857,3830,3867,3799,3867,3832,10,-25,147472,5652511240,199440
390,a1609,20160623,3867,3832,3845,3900,3834,3845,3871,13,39,200578,7764411320,199012
391,a1609,20160624,3845,3871,3844,3896,3812,3814,3864,-57,-7,233250,9013990060,185320
392,a1609,20160627,3814,3864,3801,3919,3780,3903,3872,39,8,200862,7778638740,177318
393,a1609,20160628,3903,3872,3893,4009,3889,3986,3959,114,87,278490,11025774520,181734
394,a1609,20160629,3986,3959,4015,4015,3917,3932,3960,-27,1,223488,8850909580,175710
395,a1609,20160630,3932,3960,3921,3968,3921,3940,3947,-20,-13,159498,6296023740,178638
396,a1609,20160701,3940,3947,3930,4026,3896,3924,3946,-23,-1,257486,10161058960,186556
397,a1609,20160704,3924,3946,3915,3968,3892,3908,3933,-38,-13,294098,11568209240,197316
398,a1609,20160705,3908,3933,3906,3927,3811,3859,3874,-74,-59,258164,10002181620,174276
399,a1609,20160706,3859,3874,3865,3888,3747,3768,3805,-106,-69,246476,9380765780,163486
400,a1609,20160707,3768,3805,3741,3826,3706,3733,3751,-72,-54,196930,7388598780,146324
401,a1609,20160708,3733,3751,3764,3792,3704,3741,3742,-10,-9,208378,7797698020,135164
402,a1609,20160711,3741,3742,3763,3840,3738,3780,3788,38,46,161750,6127125500,133390
403,a1609,20160712,3780,3788,3794,3803,3724,3754,3759,-34,-29,184980,6954462160,139040
404,a1609,20160713,3754,3759,3750,3861,3745,3841,3809,82,50,198350,7556065700,126170
405,a1609,20160714,3841,3809,3878,3887,3813,3871,3854,62,45,134748,5193699380,112342
406,a1609,20160715,3871,3854,3884,3895,3780,3817,3820,-37,-34,151268,5779241660,99876
407,a1609,20160718,3817,3820,3795,3832,3755,3768,3800,-52,-20,114582,4354331000,97954
408,a1609,20160719,3768,3800,3770,3806,3752,3788,3785,-12,-15,77432,2931328860,93956
409,a1609,20160720,3788,3785,3776,3793,3706,3753,3748,-32,-37,94018,3523800240,82158
410,a1609,20160721,3753,3748,3744,3752,3688,3701,3710,-47,-38,84908,3150613200,76906
411,a1609,20160722,3701,3710,3707,3708,3596,3612,3652,-98,-58,92878,3391990280,76540
412,a1609,20160725,3612,3652,3605,3610,3540,3583,3580,-69,-72,70296,2516685220,67572
413,a1609,20160726,3583,3580,3600,3603,3560,3599,3579,19,-1,41726,1493582800,64430
414,a1609,20160727,3599,3579,3580,3618,3573,3592,3598,13,19,37104,1335177620,59182
415,a1609,20160728,3592,3598,3609,3625,3575,3595,3605,-3,7,31674,1141987120,55252
416,a1609,20160729,3595,3605,3587,3605,3525,3551,3566,-54,-39,28794,1027046080,54804
417,a1609,20160801,3551,3566,3551,3616,3547,3587,3583,21,17,25640,918832980,49054
418,a1609,20160802,3587,3583,3570,3596,3526,3572,3561,-11,-22,20194,719259620,46624
419,a1609,20160803,3572,3561,3565,3583,3553,3574,3566,13,5,15606,556555740,42892
420,a1609,20160804,3574,3566,3585,3595,3541,3581,3566,15,0,14160,505050280,42222
421,a1609,20160805,3581,3566,3579,3623,3571,3608,3600,42,34,20276,730113920,39206
422,a1609,20160808,3608,3600,3599,3650,3591,3603,3629,3,29,19508,707985040,33978
423,a1609,20160809,3603,3629,3608,3621,3572,3601,3600,-28,-29,16352,588795920,29668
424,a1609,20160810,3601,3600,3588,3645,3588,3637,3623,37,23,17766,643744900,24646
425,a1609,20160811,3637,3623,3648,3648,3610,3629,3631,6,8,9782,355218180,22340
426,a1609,20160812,3629,3631,3631,3647,3623,3646,3635,15,4,6890,250514580,21202
427,a1609,20160815,3646,3635,3638,3695,3606,3686,3656,51,21,15546,568431480,21908
428,a1609,20160816,3686,3656,3690,3706,3673,3702,3694,46,38,7764,286858440,21658
429,a1609,20160817,3702,3694,3704,3784,3672,3770,3736,76,42,16414,613303640,16664
430,a1609,20160818,3770,3736,3771,3791,3746,3760,3767,24,31,7028,264759640,15104
431,a1609,20160819,3760,3767,3753,3763,3689,3714,3721,-53,-46,8758,325919740,11962
432,a1609,20160822,3714,3721,3714,3761,3697,3716,3730,-5,9,9692,361525640,7778
433,a1609,20160823,3716,3730,3710,3738,3679,3679,3714,-51,-16,4402,163517160,6080
434,a1609,20160824,3679,3714,3699,3705,3634,3661,3668,-53,-46,5746,210771300,5104
435,a1609,20160825,3661,3668,3661,3672,3629,3654,3651,-14,-17,1454,53099840,4478
436,a1609,20160826,3654,3651,3652,3652,3601,3618,3629,-33,-22,2036,73900800,3798
437,a1609,20160829,3618,3629,3633,3647,3615,3633,3634,4,5,1240,45061600,2820
438,a1609,20160830,3633,3634,3633,3657,3625,3629,3642,-5,8,1116,40646460,2352
439,a1609,20160831,3629,3642,3626,3650,3530,3542,3566,-100,-76,1966,70118380,2170
440,a1609,20160901,3542,3566,3541,3549,3532,3549,3540,-17,-26,80,2832020,688
441,a1609,20160902,3549,3540,3530,3554,3510,3510,3532,-30,-8,560,19782680,218
442,a1609,20160905,3510,3532,3477,3500,3450,3450,3485,-82,-47,360,12549540,214
443,a1609,20160906,3450,3485,0,0,0,3482,3482,-3,-3,0,0,214
444,a1609,20160907,3482,3482,0,0,0,3482,3482,0,0,0,0,134
445,a1609,20160908,3482,3482,3512,3512,3512,3512,3512,30,30,2,70240,134
446,a1609,20160909,3512,3512,3500,3715,3496,3498,3575,-14,63,282,10084160,212
447,a1609,20160912,3498,3575,3541,3622,3489,3525,3528,-50,-47,104,3669860,196
448,a1609,20160913,3525,3528,3521,3530,3521,3530,3527,2,-1,6,211620,202
449,a1609,20160914,3530,3527,3530,3620,3529,3620,3530,93,3,84,2985720,0
450,a1611,20160104,3579,3584,0,0,0,3573,3573,-11,-11,0,0,18
451,a1611,20160105,3573,3573,0,0,0,3571,3571,-2,-2,0,0,18
452,a1611,20160106,3571,3571,3530,3530,3498,3498,3516,-73,-55,10,351620,20
453,a1611,20160107,3498,3516,3505,3524,3503,3504,3506,-12,-10,14,490920,24
454,a1611,20160108,3504,3506,0,0,0,3517,3517,11,11,0,0,24
455,a1611,20160111,3517,3517,3450,3450,3450,3450,3450,-67,-67,2,69000,24
456,a1611,20160112,3450,3450,3431,3537,3368,3445,3455,-5,5,74,2557360,28
457,a1611,20160113,3445,3455,3451,3486,3450,3450,3456,-5,1,16,553000,28
458,a1611,20160114,3450,3456,3488,3489,3449,3488,3483,32,27,36,1254100,26
459,a1611,20160115,3488,3483,0,0,0,3479,3479,-4,-4,0,0,26
460,a1611,20160118,3479,3479,3474,3474,3474,3474,3474,-5,-5,2,69480,26
461,a1611,20160119,3474,3474,0,0,0,3504,3504,30,30,0,0,26
462,a1611,20160120,3504,3504,3502,3502,3502,3502,3502,-2,-2,2,70040,26
463,a1611,20160121,3502,3502,0,0,0,3500,3500,-2,-2,0,0,26
464,a1611,20160122,3500,3500,3494,3505,3494,3494,3495,-6,-5,14,489380,14
465,a1611,20160125,3494,3495,0,0,0,3491,3491,-4,-4,0,0,14
466,a1611,20160126,3491,3491,0,0,0,3476,3476,-15,-15,0,0,14
467,a1611,20160127,3476,3476,3467,3473,3444,3473,3462,-3,-14,8,277020,14
468,a1611,20160128,3473,3462,3477,3477,3450,3450,3466,-12,4,6,207960,10
469,a1611,20160129,3450,3466,0,0,0,3451,3451,-15,-15,0,0,10
470,a1611,20160201,3451,3451,0,0,0,3451,3451,0,0,0,0,10
471,a1611,20160202,3451,3451,0,0,0,3451,3451,0,0,0,0,10
472,a1611,20160203,3451,3451,0,0,0,3451,3451,0,0,0,0,10
473,a1611,20160204,3451,3451,3378,3378,3378,3378,3378,-73,-73,2,67560,10
474,a1611,20160205,3378,3378,0,0,0,3378,3378,0,0,0,0,10
475,a1611,20160215,3378,3378,3371,3371,3371,3371,3371,-7,-7,2,67420,8
476,a1611,20160216,3371,3371,0,0,0,3373,3373,2,2,0,0,8
477,a1611,20160217,3373,3373,0,0,0,3372,3372,-1,-1,0,0,8
478,a1611,20160218,3372,3372,0,0,0,3372,3372,0,0,0,0,8
479,a1611,20160219,3372,3372,0,0,0,3372,3372,0,0,0,0,8
480,a1611,20160222,3372,3372,0,0,0,3395,3395,23,23,0,0,8
481,a1611,20160223,3395,3395,0,0,0,3399,3399,4,4,0,0,8
482,a1611,20160224,3399,3399,0,0,0,3390,3390,-9,-9,0,0,8
483,a1611,20160225,3390,3390,0,0,0,3385,3385,-5,-5,0,0,8
484,a1611,20160226,3385,3385,0,0,0,3388,3388,3,3,0,0,8
485,a1611,20160229,3388,3388,0,0,0,3388,3388,0,0,0,0,8
486,a1611,20160301,3388,3388,0,0,0,3388,3388,0,0,0,0,8
487,a1611,20160302,3388,3388,3400,3400,3400,3400,3400,12,12,6,204000,14
488,a1611,20160303,3400,3400,3416,3487,3416,3484,3455,84,55,14,483740,16
489,a1611,20160304,3484,3455,0,0,0,3483,3483,28,28,0,0,16
490,a1611,20160307,3483,3483,3496,3508,3496,3508,3502,25,19,4,140080,14
491,a1611,20160308,3508,3502,0,0,0,3502,3502,0,0,0,0,14
492,a1611,20160309,3502,3502,0,0,0,3489,3489,-13,-13,0,0,14
493,a1611,20160310,3489,3489,0,0,0,3474,3474,-15,-15,0,0,14
494,a1611,20160311,3474,3474,0,0,0,3454,3454,-20,-20,0,0,14
495,a1611,20160314,3454,3454,0,0,0,3454,3454,0,0,0,0,14
496,a1611,20160315,3454,3454,0,0,0,3441,3441,-13,-13,0,0,14
497,a1611,20160316,3441,3441,0,0,0,3404,3404,-37,-37,0,0,14
498,a1611,20160317,3404,3404,0,0,0,3404,3404,0,0,0,0,14
499,a1611,20160318,3404,3404,3492,3492,3455,3455,3473,51,69,8,277880,14
500,a1611,20160321,3455,3473,3392,3490,3392,3475,3473,2,0,22,764220,32
501,a1611,20160322,3475,3473,3498,3521,3497,3515,3506,42,33,16,561020,20
502,a1611,20160323,3515,3506,3516,3540,3516,3540,3526,34,20,10,352640,18
503,a1611,20160324,3540,3526,0,0,0,3513,3513,-13,-13,0,0,18
504,a1611,20160325,3513,3513,3554,3576,3553,3553,3563,40,50,14,498920,26
505,a1611,20160328,3553,3563,3565,3567,3534,3534,3553,-29,-10,44,1563540,26
506,a1611,20160329,3534,3553,3495,3525,3495,3505,3508,-48,-45,12,421000,22
507,a1611,20160330,3505,3508,3519,3523,3506,3506,3517,-2,9,12,422060,24
508,a1611,20160331,3506,3517,3474,3474,3474,3474,3474,-43,-43,4,138960,22
509,a1611,20160401,3474,3474,0,0,0,3470,3470,-4,-4,0,0,22
510,a1611,20160405,3470,3470,3342,3395,3342,3395,3374,-75,-96,8,269980,16
511,a1611,20160406,3395,3374,3359,3359,3359,3359,3359,-15,-15,2,67180,16
512,a1611,20160407,3359,3359,3352,3352,3352,3352,3352,-7,-7,4,134080,12
513,a1611,20160408,3352,3352,0,0,0,3352,3352,0,0,0,0,12
514,a1611,20160411,3352,3352,0,0,0,3363,3363,11,11,0,0,12
515,a1611,20160412,3363,3363,3385,3385,3385,3385,3385,22,22,2,67700,12
516,a1611,20160413,3385,3385,3471,3471,3441,3441,3456,56,71,4,138240,12
517,a1611,20160414,3441,3456,3411,3495,3411,3480,3469,24,13,16,555140,18
518,a1611,20160415,3480,3469,0,0,0,3447,3447,-22,-22,0,0,18
519,a1611,20160418,3447,3447,3457,3492,3457,3492,3482,45,35,8,278560,16
520,a1611,20160419,3492,3482,3526,3527,3483,3498,3505,16,23,18,630920,14
521,a1611,20160420,3498,3505,3590,3641,3590,3624,3602,119,97,18,648480,20
522,a1611,20160421,3624,3602,0,0,0,3673,3673,71,71,0,0,20
523,a1611,20160422,3673,3673,3811,3819,3756,3762,3800,89,127,22,836160,16
524,a1611,20160425,3762,3800,3748,3794,3748,3794,3771,-6,-29,4,150840,14
525,a1611,20160426,3794,3771,3717,3717,3717,3717,3717,-54,-54,4,148680,14
526,a1611,20160427,3717,3717,0,0,0,3717,3717,0,0,0,0,14
527,a1611,20160428,3717,3717,3671,3671,3671,3671,3671,-46,-46,2,73420,12
528,a1611,20160429,3671,3671,0,0,0,3671,3671,0,0,0,0,12
529,a1611,20160503,3671,3671,0,0,0,3673,3673,2,2,0,0,12
530,a1611,20160504,3673,3673,3624,3624,3624,3624,3624,-49,-49,4,144960,14
531,a1611,20160505,3624,3624,3670,3679,3656,3656,3671,32,47,22,807680,20
532,a1611,20160506,3656,3671,0,0,0,3598,3598,-73,-73,0,0,20
533,a1611,20160509,3598,3598,0,0,0,3573,3573,-25,-25,0,0,20
534,a1611,20160510,3573,3573,0,0,0,3573,3573,0,0,0,0,20
535,a1611,20160511,3573,3573,3728,3750,3646,3708,3698,135,125,1474,54515200,498
536,a1611,20160512,3708,3698,3685,3736,3629,3736,3676,38,-22,174,6396860,444
537,a1611,20160513,3736,3676,3687,3687,3565,3589,3636,-87,-40,54,1963740,418
538,a1611,20160516,3589,3636,3593,3602,3589,3592,3594,-44,-42,16,575140,418
539,a1611,20160517,3592,3594,3649,3689,3649,3689,3671,95,77,16,587420,408
540,a1611,20160518,3689,3671,3717,3770,3717,3763,3743,92,72,72,2695360,366
541,a1611,20160519,3763,3743,3747,3747,3717,3717,3723,-26,-20,12,446760,366
542,a1611,20160520,3717,3723,3732,3732,3705,3729,3725,6,2,12,447020,358
543,a1611,20160523,3729,3725,3750,3750,3659,3695,3702,-30,-23,48,1777340,324
544,a1611,20160524,3695,3702,3663,3663,3583,3583,3600,-119,-102,128,4609100,224
545,a1611,20160525,3583,3600,3569,3592,3569,3592,3578,-8,-22,10,357820,216
546,a1611,20160526,3592,3578,3625,3665,3625,3665,3643,87,65,6,218600,212
547,a1611,20160527,3665,3643,3698,3698,3698,3698,3698,55,55,2,73960,210
548,a1611,20160530,3698,3698,3691,3770,3688,3770,3703,72,5,12,444400,210
549,a1611,20160531,3770,3703,3702,3702,3702,3702,3702,-1,-1,2,74040,208
550,a1611,20160601,3702,3702,3786,3795,3786,3795,3788,93,86,8,303060,204
551,a1611,20160602,3795,3788,0,0,0,3788,3788,0,0,0,0,204
552,a1611,20160603,3788,3788,3830,3830,3826,3826,3826,38,38,14,535720,210
553,a1611,20160606,3826,3826,3827,3827,3810,3811,3812,-15,-14,18,686280,212
554,a1611,20160607,3811,3812,3810,3820,3810,3820,3818,8,6,108,4124380,108
555,a1611,20160608,3820,3818,3794,3806,3784,3784,3794,-34,-24,32,1214340,104
556,a1611,20160613,3784,3794,0,0,0,3794,3794,0,0,0,0,104
557,a1611,20160614,3794,3794,0,0,0,3794,3794,0,0,0,0,104
558,a1611,20160615,3794,3794,3809,3878,3809,3878,3843,84,49,20,768700,102
559,a1611,20160616,3878,3843,3861,3861,3861,3861,3861,18,18,2,77220,102
560,a1611,20160617,3861,3861,3826,3826,3826,3826,3826,-35,-35,4,153040,102
561,a1611,20160620,3826,3826,3842,3842,3842,3842,3842,16,16,2,76840,102
562,a1611,20160621,3842,3842,0,0,0,3842,3842,0,0,0,0,102
563,a1611,20160622,3842,3842,3821,3821,3821,3821,3821,-21,-21,6,229260,102
564,a1611,20160623,3821,3821,3865,3870,3864,3870,3867,49,46,14,541480,100
565,a1611,20160624,3870,3867,3841,3855,3830,3830,3842,-37,-25,6,230520,100
566,a1611,20160627,3830,3842,3907,3907,3875,3875,3891,33,49,4,155640,100
567,a1611,20160628,3875,3891,3914,3980,3914,3980,3969,89,78,18,714500,100
568,a1611,20160629,3980,3969,3900,3938,3900,3938,3904,-31,-65,74,2889040,100
569,a1611,20160630,3938,3904,3876,3943,3876,3943,3921,39,17,24,941040,100
570,a1611,20160701,3943,3921,3917,3970,3911,3959,3941,38,20,28,1103540,94
571,a1611,20160704,3959,3941,3953,3953,3953,3953,3953,12,12,2,79060,94
572,a1611,20160705,3953,3953,3941,3941,3904,3909,3918,-44,-35,6,235080,94
573,a1611,20160706,3909,3918,3743,3838,3743,3838,3790,-80,-128,4,151620,94
574,a1611,20160707,3838,3790,3703,3703,3703,3703,3703,-87,-87,2,74060,94
575,a1611,20160708,3703,3703,3783,3836,3717,3741,3754,38,51,60,2252540,72
576,a1611,20160711,3741,3754,3814,3841,3755,3815,3800,61,46,14,532000,72
577,a1611,20160712,3815,3800,0,0,0,3800,3800,0,0,0,0,72
578,a1611,20160713,3800,3800,3806,3862,3806,3862,3826,62,26,6,229580,66
579,a1611,20160714,3862,3826,0,0,0,3891,3891,65,65,0,0,66
580,a1611,20160715,3891,3891,3946,3946,3879,3879,3912,-12,21,4,156500,66
581,a1611,20160718,3879,3912,0,0,0,3912,3912,0,0,0,0,66
582,a1611,20160719,3912,3912,3755,3827,3755,3826,3794,-86,-118,22,834720,60
583,a1611,20160720,3826,3794,0,0,0,3794,3794,0,0,0,0,60
584,a1611,20160721,3794,3794,3762,3762,3755,3755,3759,-39,-35,8,300780,54
585,a1611,20160722,3755,3759,3698,3699,3698,3699,3698,-60,-61,4,147940,54
586,a1611,20160725,3699,3698,0,0,0,3647,3647,-51,-51,0,0,54
587,a1611,20160726,3647,3647,0,0,0,3647,3647,0,0,0,0,54
588,a1611,20160727,3647,3647,0,0,0,3647,3647,0,0,0,0,54
589,a1611,20160728,3647,3647,3640,3640,3602,3602,3621,-45,-26,4,144840,54
590,a1611,20160729,3602,3621,3608,3608,3608,3608,3608,-13,-13,2,72160,52
591,a1611,20160801,3608,3608,3615,3615,3615,3615,3615,7,7,2,72300,52
592,a1611,20160802,3615,3615,0,0,0,3615,3615,0,0,0,0,52
593,a1611,20160803,3615,3615,0,0,0,3615,3615,0,0,0,0,52
594,a1611,20160804,3615,3615,3642,3642,3598,3598,3620,-17,5,4,144800,52
595,a1611,20160805,3598,3620,0,0,0,3633,3633,13,13,0,0,52
596,a1611,20160808,3633,3633,0,0,0,3635,3635,2,2,0,0,52
597,a1611,20160809,3635,3635,0,0,0,3635,3635,0,0,0,0,52
598,a1611,20160810,3635,3635,3689,3690,3537,3537,3613,-98,-22,8,289060,50
599,a1611,20160811,3537,3613,0,0,0,3613,3613,0,0,0,0,50
600,a1611,20160812,3613,3613,0,0,0,3613,3613,0,0,0,0,50
601,a1611,20160815,3613,3613,0,0,0,3613,3613,0,0,0,0,50
602,a1611,20160816,3613,3613,3740,3740,3740,3740,3740,127,127,6,224400,44
603,a1611,20160817,3740,3740,3748,3789,3748,3789,3756,49,16,10,375620,40
604,a1611,20160818,3789,3756,3811,3851,3772,3772,3811,16,55,14,533600,34
605,a1611,20160819,3772,3811,0,0,0,3806,3806,-5,-5,0,0,34
606,a1611,20160822,3806,3806,3767,3860,3767,3838,3817,32,11,12,458140,32
607,a1611,20160823,3838,3817,3806,3806,3806,3806,3806,-11,-11,2,76120,34
608,a1611,20160824,3806,3806,0,0,0,3806,3806,0,0,0,0,34
609,a1611,20160825,3806,3806,3687,3762,3687,3762,3712,-44,-94,6,222720,34
610,a1611,20160826,3762,3712,3707,3707,3707,3707,3707,-5,-5,4,148280,30
611,a1611,20160829,3707,3707,0,0,0,3700,3700,-7,-7,0,0,30
612,a1611,20160830,3700,3700,3735,3735,3725,3727,3729,27,29,6,223740,34
613,a1611,20160831,3727,3729,3689,3697,3637,3637,3674,-92,-55,10,367440,36
614,a1611,20160901,3637,3674,3607,3636,3607,3612,3618,-62,-56,6,217100,40
615,a1611,20160902,3612,3618,3581,3602,3577,3602,3591,-16,-27,24,861860,56
616,a1611,20160905,3602,3591,0,0,0,3534,3534,-57,-57,0,0,56
617,a1611,20160906,3534,3534,0,0,0,3529,3529,-5,-5,0,0,56
618,a1611,20160907,3529,3529,0,0,0,3542,3542,13,13,0,0,56
619,a1611,20160908,3542,3542,0,0,0,3542,3542,0,0,0,0,56
620,a1611,20160909,3542,3542,0,0,0,3542,3542,0,0,0,0,56
621,a1611,20160912,3542,3542,0,0,0,3542,3542,0,0,0,0,56
622,a1611,20160913,3542,3542,0,0,0,3542,3542,0,0,0,0,56
623,a1611,20160914,3542,3542,3510,3554,3505,3553,3521,11,-21,24,845260,66
624,a1611,20160919,3553,3521,3614,3697,3565,3697,3631,176,110,56,2033520,74
625,a1611,20160920,3697,3631,3804,3804,3677,3755,3739,124,108,32,1196720,70
626,a1611,20160921,3755,3739,3750,3750,3660,3689,3699,-50,-40,12,443960,66
627,a1611,20160922,3689,3699,3692,3712,3692,3712,3699,13,0,6,221940,70
628,a1611,20160923,3712,3699,3697,3697,3697,3697,3697,-2,-2,2,73940,70
629,a1611,20160926,3697,3697,3688,3688,3656,3656,3672,-41,-25,4,146880,68
630,a1611,20160927,3656,3672,3669,3669,3629,3629,3649,-43,-23,8,291960,64
631,a1611,20160928,3629,3649,3608,3609,3577,3577,3594,-72,-55,14,503280,58
632,a1611,20160929,3577,3594,3565,3768,3506,3657,3619,63,25,10,361960,58
633,a1611,20160930,3657,3619,3522,3606,3522,3606,3564,-13,-55,4,142560,58
634,a1611,20161010,3606,3564,3688,3688,3576,3645,3657,81,93,10,365700,66
635,a1611,20161011,3645,3657,3652,3652,3611,3636,3634,-21,-23,8,290760,66
636,a1611,20161012,3636,3634,3604,3604,3604,3604,3604,-30,-30,2,72080,66
637,a1611,20161013,3604,3604,3635,3635,3540,3545,3583,-59,-21,26,931740,72
638,a1611,20161014,3545,3583,3600,3600,3600,3600,3600,17,17,2,72000,72
639,a1611,20161017,3600,3600,3610,3612,3610,3612,3611,12,11,4,144440,70
640,a1611,20161018,3612,3611,0,0,0,3607,3607,-4,-4,0,0,70
641,a1611,20161019,3607,3607,3610,3610,3546,3575,3569,-32,-38,8,285540,74
642,a1611,20161020,3575,3569,3625,3626,3625,3626,3625,57,56,10,362580,82
643,a1611,20161021,3626,3625,3708,3720,3595,3660,3670,35,45,48,1761960,90
644,a1611,20161024,3660,3670,3680,3690,3656,3690,3677,20,7,14,514800,92
645,a1611,20161025,3690,3677,3746,3746,3670,3670,3707,-7,30,16,593140,94
646,a1611,20161026,3670,3707,3680,3762,3558,3762,3697,55,-10,66,2440040,106
647,a1611,20161027,3762,3697,3838,3838,3750,3780,3800,83,103,38,1444220,104
648,a1611,20161028,3780,3800,3790,3790,3776,3776,3782,-24,-18,10,378280,98
649,a1611,20161031,3776,3782,3767,3939,3731,3939,3784,157,2,24,908240,80
650,a1611,20161101,3939,3784,3770,3780,3770,3780,3778,-4,-6,12,453400,18
651,a1611,20161102,3780,3778,3822,3822,3822,3822,3822,44,44,14,535080,32
652,a1611,20161103,3822,3822,3600,3600,3600,3600,3600,-222,-222,14,504000,30
653,a1611,20161104,3600,3600,0,0,0,3600,3600,0,0,0,0,30
654,a1611,20161107,3600,3600,0,0,0,3601,3601,1,1,0,0,30
655,a1611,20161108,3601,3601,0,0,0,3700,3700,99,99,0,0,0
656,a1611,20161109,3700,3700,0,0,0,3700,3700,0,0,0,0,0
657,a1611,20161110,3700,3700,3860,3860,3860,3860,3860,160,160,12,463200,12
658,a1611,20161111,3860,3860,0,0,0,3860,3860,0,0,0,0,0
659,a1611,20161114,3860,3860,3760,3760,3760,3760,3760,-100,-100,2,75200,0
660,a1701,20160104,3484,3491,3477,3497,3400,3419,3436,-72,-55,4930,169423460,12512
661,a1701,20160105,3419,3436,3420,3440,3420,3435,3430,-1,-6,3132,107452700,12848
662,a1701,20160106,3435,3430,3430,3437,3413,3417,3420,-13,-10,2680,91656100,13916
663,a1701,20160107,3417,3420,3411,3439,3409,3425,3426,5,6,1642,56255120,13874
664,a1701,20160108,3425,3426,3429,3444,3424,3438,3435,12,9,2262,77711020,13826
665,a1701,20160111,3438,3435,3439,3446,3413,3419,3429,-16,-6,2506,85948540,14328
666,a1701,20160112,3419,3429,3416,3429,3412,3417,3420,-12,-9,1762,60272900,14924
667,a1701,20160113,3417,3420,3425,3450,3425,3439,3438,19,18,1492,51302700,14834
668,a1701,20160114,3439,3438,3436,3442,3427,3432,3432,-6,-6,986,33844360,14878
669,a1701,20160115,3432,3432,3430,3440,3428,3428,3432,-4,0,676,23205840,14622
670,a1701,20160118,3428,3432,3416,3451,3416,3450,3434,18,2,1390,47740160,14574
671,a1701,20160119,3450,3434,3454,3487,3445,3479,3465,45,31,1660,57531860,14416
672,a1701,20160120,3479,3465,3482,3493,3465,3468,3479,3,14,1156,40221460,14606
673,a1701,20160121,3468,3479,3463,3473,3461,3463,3466,-16,-13,1308,45342940,14564
674,a1701,20160122,3463,3466,3470,3489,3461,3488,3478,22,12,1206,41956240,14726
675,a1701,20160125,3488,3478,3491,3495,3464,3464,3478,-14,0,1856,64563420,14748
676,a1701,20160126,3464,3478,3465,3470,3447,3459,3456,-19,-22,1064,36774480,14956
677,a1701,20160127,3459,3456,3459,3461,3443,3446,3448,-10,-8,1816,62625640,15740
678,a1701,20160128,3446,3448,3439,3451,3421,3423,3436,-25,-12,2630,90388460,16718
679,a1701,20160129,3423,3436,3423,3433,3415,3419,3423,-17,-13,1754,60050200,16716
680,a1701,20160201,3419,3423,3421,3435,3419,3423,3428,0,5,608,20842960,16666
681,a1701,20160202,3423,3428,3417,3430,3416,3424,3422,-4,-6,1002,34297160,16568
682,a1701,20160203,3424,3422,3421,3428,3417,3427,3422,5,0,1386,47434800,16608
683,a1701,20160204,3427,3422,3428,3428,3388,3398,3404,-24,-18,2562,87227900,16954
684,a1701,20160205,3398,3404,3398,3398,3372,3381,3380,-23,-24,1768,59768640,17162
685,a1701,20160215,3381,3380,3375,3398,3360,3370,3375,-10,-5,1786,60281200,17510
686,a1701,20160216,3370,3375,3373,3394,3372,3388,3388,13,13,2888,97853780,17140
687,a1701,20160217,3388,3388,3388,3392,3380,3391,3387,3,-1,3624,122748980,15588
688,a1701,20160218,3391,3387,3383,3395,3382,3388,3387,1,0,5590,189362180,16436
689,a1701,20160219,3388,3387,3384,3394,3378,3389,3388,2,1,1950,66073460,16896
690,a1701,20160222,3389,3388,3387,3431,3387,3428,3409,40,21,4876,166266360,16346
691,a1701,20160223,3428,3409,3425,3437,3412,3428,3425,19,16,2612,89462820,16394
692,a1701,20160224,3428,3425,3428,3434,3398,3403,3409,-22,-16,3822,130324580,17244
693,a1701,20160225,3403,3409,3400,3412,3386,3391,3397,-18,-12,1818,61768440,17180
694,a1701,20160226,3391,3397,3390,3404,3387,3392,3397,-5,0,1628,55306340,17172
695,a1701,20160229,3392,3397,3391,3403,3323,3354,3355,-43,-42,5438,182451900,18224
696,a1701,20160301,3354,3355,3355,3382,3354,3371,3367,16,12,2652,89293880,17528
697,a1701,20160302,3371,3367,3376,3408,3372,3399,3392,32,25,2818,95587920,17264
698,a1701,20160303,3399,3392,3399,3450,3393,3439,3427,47,35,5436,186308660,17888
699,a1701,20160304,3439,3427,3436,3466,3425,3456,3445,29,18,6946,239335000,16522
700,a1701,20160307,3456,3445,3466,3494,3437,3456,3469,11,24,9142,317154620,16506
701,a1701,20160308,3456,3469,3468,3486,3446,3464,3467,-5,-2,6372,220930480,16794
702,a1701,20160309,3464,3467,3470,3477,3441,3448,3456,-19,-11,4276,147779300,17102
703,a1701,20160310,3448,3456,3457,3469,3441,3449,3450,-7,-6,3144,108472320,17084
704,a1701,20160311,3449,3450,3449,3452,3419,3433,3431,-17,-19,3042,104379860,17858
705,a1701,20160314,3433,3431,3440,3454,3428,3430,3438,-1,7,3804,130785680,19050
706,a1701,20160315,3430,3438,3430,3439,3405,3407,3417,-31,-21,5966,203902240,19536
707,a1701,20160316,3407,3417,3400,3411,3373,3389,3390,-28,-27,6362,215716700,20018
708,a1701,20160317,3389,3390,3382,3408,3381,3405,3398,15,8,3232,109833980,20460
709,a1701,20160318,3405,3398,3408,3492,3408,3466,3461,68,63,14756,510758320,18990
710,a1701,20160321,3466,3461,3461,3487,3447,3473,3466,12,5,6838,237072820,20044
711,a1701,20160322,3473,3466,3476,3526,3476,3520,3506,54,40,16798,588990820,25118
712,a1701,20160323,3520,3506,3519,3564,3506,3513,3540,7,34,18144,642298720,27202
713,a1701,20160324,3513,3540,3500,3548,3492,3510,3523,-30,-17,17892,630389480,26992
714,a1701,20160325,3510,3523,3503,3565,3491,3556,3547,33,24,17794,631179660,28626
715,a1701,20160328,3556,3547,3559,3572,3516,3520,3548,-27,1,19064,676562340,29622
716,a1701,20160329,3520,3548,3514,3521,3471,3474,3496,-74,-52,38064,1331016020,41048
717,a1701,20160330,3474,3496,3478,3505,3475,3486,3487,-10,-9,23248,810698400,44464
718,a1701,20160331,3486,3487,3488,3495,3445,3461,3463,-26,-24,19874,688391440,44792
719,a1701,20160401,3461,3463,3465,3469,3394,3395,3425,-68,-38,35392,1212359460,49278
720,a1701,20160405,3395,3425,3390,3409,3385,3393,3398,-32,-27,18454,627240700,54530
721,a1701,20160406,3393,3398,3389,3390,3344,3351,3360,-47,-38,23986,805938700,57488
722,a1701,20160407,3351,3360,3344,3372,3342,3354,3360,-6,0,11424,383847220,59224
723,a1701,20160408,3354,3360,3355,3370,3345,3350,3355,-10,-5,13770,462002360,59548
724,a1701,20160411,3350,3355,3355,3399,3350,3378,3379,23,24,20412,689798020,58366
725,a1701,20160412,3378,3379,3384,3415,3377,3412,3400,33,21,17836,606429680,57430
726,a1701,20160413,3412,3400,3419,3467,3412,3427,3438,27,38,65918,2266897940,69672
727,a1701,20160414,3427,3438,3426,3475,3426,3449,3454,11,16,40508,1399352380,77794
728,a1701,20160415,3449,3454,3450,3462,3427,3441,3447,-13,-7,29010,999998220,80220
729,a1701,20160418,3441,3447,3425,3509,3425,3492,3480,45,33,43618,1517972660,83940
730,a1701,20160419,3492,3480,3490,3531,3490,3510,3509,30,29,31888,1119191340,84298
731,a1701,20160420,3510,3509,3516,3649,3515,3649,3607,140,98,71762,2588890280,80754
732,a1701,20160421,3649,3607,3648,3823,3623,3823,3750,216,143,72354,2713573560,68872
733,a1701,20160422,3823,3750,3823,3892,3633,3715,3788,-35,38,115016,4357456540,67118
734,a1701,20160425,3715,3788,3705,3863,3690,3745,3770,-43,-18,86654,3267684620,75938
735,a1701,20160426,3745,3770,3745,3805,3714,3747,3761,-23,-9,44122,1659430700,75714
736,a1701,20160427,3747,3761,3750,3777,3714,3727,3744,-34,-17,34754,1301278000,75836
737,a1701,20160428,3727,3744,3730,3741,3624,3647,3673,-97,-71,43998,1616078520,73990
738,a1701,20160429,3647,3673,3660,3702,3630,3637,3668,-36,-5,38278,1404305280,76266
739,a1701,20160503,3637,3668,3651,3745,3650,3736,3705,68,37,41244,1528460980,83488
740,a1701,20160504,3736,3705,3735,3765,3662,3673,3695,-32,-10,38402,1419114560,83280
741,a1701,20160505,3673,3695,3668,3696,3636,3648,3665,-47,-30,36490,1337490320,83536
742,a1701,20160506,3648,3665,3672,3683,3540,3553,3588,-112,-77,51642,1853008300,82496
743,a1701,20160509,3553,3588,3550,3615,3535,3561,3569,-27,-19,51520,1839193640,89964
744,a1701,20160510,3561,3569,3557,3569,3500,3543,3528,-26,-41,35076,1237745180,91240
745,a1701,20160511,3543,3528,3555,3704,3542,3704,3659,176,131,87436,3200079520,104482
746,a1701,20160512,3704,3659,3703,3749,3643,3680,3687,21,28,82432,3039287140,104290
747,a1701,20160513,3680,3687,3682,3708,3575,3615,3637,-72,-50,67148,2442801940,100278
748,a1701,20160516,3615,3637,3601,3686,3600,3666,3648,29,11,42764,1560095240,99920
749,a1701,20160517,3666,3648,3666,3718,3660,3715,3693,67,45,44294,1636208820,103952
750,a1701,20160518,3715,3693,3722,3807,3686,3718,3751,25,58,60444,2267721140,102464
751,a1701,20160519,3718,3751,3718,3758,3675,3750,3728,-1,-23,60302,2248411480,104318
752,a1701,20160520,3750,3728,3710,3744,3707,3737,3725,9,-3,29764,1108869120,103730
753,a1701,20160523,3737,3725,3764,3788,3677,3688,3716,-37,-9,46374,1723560920,98268
754,a1701,20160524,3688,3716,3695,3698,3566,3580,3628,-136,-88,64198,2329421560,92148
755,a1701,20160525,3580,3628,3570,3620,3558,3605,3594,-23,-34,36804,1323003940,95058
756,a1701,20160526,3605,3594,3614,3688,3614,3681,3650,87,56,49442,1805039100,100258
757,a1701,20160527,3681,3650,3691,3711,3631,3679,3665,29,15,37988,1392534160,98552
758,a1701,20160530,3679,3665,3665,3770,3664,3742,3723,77,58,45978,1712178300,97698
759,a1701,20160531,3742,3723,3680,3782,3654,3738,3727,15,4,66068,2462844500,102484
760,a1701,20160601,3738,3727,3740,3805,3690,3734,3758,7,31,74062,2783896860,104664
761,a1701,20160602,3734,3758,3745,3811,3715,3777,3778,19,20,47508,1795177680,107110
762,a1701,20160603,3777,3778,3782,3820,3763,3790,3796,12,18,75314,2859295840,106932
763,a1701,20160606,3790,3796,3801,3815,3770,3802,3792,6,-4,59036,2239088820,111232
764,a1701,20160607,3802,3792,3812,3823,3780,3811,3796,19,4,54270,2060508460,111996
765,a1701,20160608,3811,3796,3807,3812,3769,3801,3793,5,-3,43602,1653954940,111350
766,a1701,20160613,3801,3793,3890,3970,3887,3923,3926,130,133,52628,2066526100,112248
767,a1701,20160614,3923,3926,3909,3948,3822,3850,3876,-76,-50,57540,2230582960,116952
768,a1701,20160615,3850,3876,3860,3876,3811,3846,3841,-30,-35,49548,1903224080,116982
769,a1701,20160616,3846,3841,3860,3880,3778,3793,3825,-48,-16,50430,1929117540,118378
770,a1701,20160617,3793,3825,3799,3827,3755,3820,3795,-5,-30,42208,1602078500,121962
771,a1701,20160620,3820,3795,3825,3849,3791,3830,3820,35,25,42348,1618083320,119036
772,a1701,20160621,3830,3820,3821,3860,3802,3822,3833,2,13,41918,1606796660,119016
773,a1701,20160622,3822,3833,3810,3832,3773,3832,3803,-1,-30,30670,1166390180,117072
774,a1701,20160623,3832,3803,3815,3868,3805,3823,3838,20,35,47626,1828307080,113116
775,a1701,20160624,3823,3838,3823,3866,3793,3793,3838,-45,0,53216,2042479040,110516
776,a1701,20160627,3793,3838,3780,3884,3759,3881,3847,43,9,44264,1703151160,111700
777,a1701,20160628,3881,3847,3878,3980,3868,3950,3928,103,81,60588,2380324980,116480
778,a1701,20160629,3950,3928,3968,3971,3896,3914,3929,-14,1,51216,2012504800,116456
779,a1701,20160630,3914,3929,3901,3978,3901,3963,3949,34,20,59226,2338951300,113346
780,a1701,20160701,3963,3949,3958,4088,3925,3969,3986,20,37,98736,3936485460,122732
781,a1701,20160704,3969,3986,3960,4018,3943,3961,3982,-25,-4,102418,4078881740,135722
782,a1701,20160705,3961,3982,3972,3984,3851,3918,3923,-64,-59,76946,3018770020,128706
783,a1701,20160706,3918,3923,3920,3936,3785,3826,3848,-97,-75,83584,3216649580,121696
784,a1701,20160707,3826,3848,3800,3888,3741,3775,3803,-73,-45,79080,3008168460,122796
785,a1701,20160708,3775,3803,3801,3829,3718,3749,3762,-54,-41,89108,3352728220,116344
786,a1701,20160711,3749,3762,3775,3849,3753,3792,3801,30,39,60920,2316146140,121446
787,a1701,20160712,3792,3801,3803,3823,3765,3790,3792,-11,-9,88732,3365439200,135424
788,a1701,20160713,3790,3792,3785,3882,3774,3880,3843,88,51,87912,3378788560,142056
789,a1701,20160714,3880,3843,3930,3930,3861,3912,3898,69,55,75262,2933878440,140314
790,a1701,20160715,3912,3898,3924,3932,3819,3850,3855,-48,-43,83684,3226617600,141084
791,a1701,20160718,3850,3855,3831,3865,3793,3807,3830,-48,-25,75192,2880399220,141764
792,a1701,20160719,3807,3830,3799,3849,3790,3830,3827,0,-3,71326,2730330080,138352
793,a1701,20160720,3830,3827,3822,3834,3738,3780,3781,-47,-46,117224,4432613620,148676
794,a1701,20160721,3780,3781,3770,3784,3715,3732,3738,-49,-43,153778,5749594200,167206
795,a1701,20160722,3732,3738,3733,3739,3636,3652,3684,-86,-54,199400,7347186960,186394
796,a1701,20160725,3652,3684,3640,3658,3588,3634,3627,-50,-57,166226,6030429940,191402
797,a1701,20160726,3634,3627,3630,3651,3610,3641,3627,14,0,117510,4262732860,190674
798,a1701,20160727,3641,3627,3630,3665,3612,3635,3641,8,14,119302,4344447860,192580
799,a1701,20160728,3635,3641,3655,3670,3612,3635,3643,-6,2,134232,4891075920,204404
800,a1701,20160729,3635,3643,3627,3642,3563,3595,3602,-48,-41,151404,5455019680,210584
801,a1701,20160801,3595,3602,3595,3665,3584,3634,3630,32,28,142132,5160739480,191232
802,a1701,20160802,3634,3630,3622,3645,3573,3612,3608,-18,-22,134598,4856955040,195658
803,a1701,20160803,3612,3608,3618,3627,3587,3611,3607,3,-1,96754,3490079940,200178
804,a1701,20160804,3611,3607,3622,3630,3576,3626,3603,19,-4,122192,4403007460,200992
805,a1701,20160805,3626,3603,3631,3669,3612,3651,3643,48,40,138114,5032683920,193290
806,a1701,20160808,3651,3643,3644,3694,3637,3659,3674,16,31,150202,5519853900,188044
807,a1701,20160809,3659,3674,3670,3685,3640,3676,3669,2,-5,114350,4196184200,181104
808,a1701,20160810,3676,3669,3665,3740,3661,3731,3711,62,42,151110,5609021880,171374
809,a1701,20160811,3731,3711,3738,3745,3702,3724,3727,13,16,103716,3865621220,159434
810,a1701,20160812,3724,3727,3730,3751,3718,3749,3734,22,7,87606,3271766660,156202
811,a1701,20160815,3749,3734,3760,3810,3706,3802,3769,68,35,190556,7183151260,154504
812,a1701,20160816,3802,3769,3809,3824,3792,3820,3811,51,42,103218,3934127160,152116
813,a1701,20160817,3820,3811,3820,3904,3790,3887,3856,76,45,212716,8203760620,181298
814,a1701,20160818,3887,3856,3892,3915,3860,3875,3886,19,30,172886,6719595340,195646
815,a1701,20160819,3875,3886,3869,3882,3797,3826,3835,-60,-51,194022,7442315640,185150
816,a1701,20160822,3826,3835,3819,3885,3806,3828,3845,-7,10,172724,6641652860,198678
817,a1701,20160823,3828,3845,3811,3854,3786,3788,3825,-57,-20,110664,4232999460,199384
818,a1701,20160824,3788,3825,3800,3806,3756,3777,3781,-48,-44,161210,6095566940,178654
819,a1701,20160825,3777,3781,3770,3799,3738,3786,3771,5,-10,151826,5725573720,175910
820,a1701,20160826,3786,3771,3771,3787,3725,3744,3756,-27,-15,133044,4997315300,169422
821,a1701,20160829,3744,3756,3755,3780,3741,3759,3760,3,4,102454,3853063440,172762
822,a1701,20160830,3759,3760,3751,3789,3736,3757,3764,-3,4,108424,4081443880,178606
823,a1701,20160831,3757,3764,3751,3768,3665,3676,3704,-88,-60,182338,6755484480,171954
824,a1701,20160901,3676,3704,3668,3688,3646,3657,3666,-47,-38,131188,4809541060,169800
825,a1701,20160902,3657,3666,3661,3689,3621,3626,3653,-40,-13,166654,6088050240,175108
826,a1701,20160905,3626,3653,3636,3640,3567,3585,3604,-68,-49,211072,7607343640,204100
827,a1701,20160906,3585,3604,3585,3605,3576,3596,3592,-8,-12,106576,3828878820,196776
828,a1701,20160907,3596,3592,3593,3640,3578,3630,3619,38,27,156224,5654361920,193494
829,a1701,20160908,3630,3619,3633,3650,3619,3628,3632,9,13,132486,4812711060,199814
830,a1701,20160909,3628,3632,3630,3642,3607,3632,3624,0,-8,121884,4417814240,197926
831,a1701,20160912,3632,3624,3629,3667,3601,3644,3640,20,16,210022,7646268060,186634
832,a1701,20160913,3644,3640,3652,3674,3626,3645,3651,5,11,136402,4980682580,182696
833,a1701,20160914,3645,3651,3635,3679,3606,3675,3645,24,-6,170630,6219669660,174964
834,a1701,20160919,3675,3645,3735,3807,3711,3797,3758,152,113,191562,7199025240,166910
835,a1701,20160920,3797,3758,3804,3818,3785,3807,3800,49,42,169442,6439647480,160306
836,a1701,20160921,3807,3800,3803,3830,3750,3766,3785,-34,-15,197704,7484224640,147740
837,a1701,20160922,3766,3785,3768,3797,3746,3772,3771,-13,-14,151998,5732079420,150530
838,a1701,20160923,3772,3771,3784,3794,3732,3748,3762,-23,-9,131854,4961521640,147134
839,a1701,20160926,3748,3762,3740,3773,3724,3752,3750,-10,-12,136002,5101348040,150830
840,a1701,20160927,3752,3750,3760,3760,3680,3689,3712,-61,-38,159734,5930385600,148708
841,a1701,20160928,3689,3712,3690,3698,3660,3665,3676,-47,-36,127544,4689606700,144352
842,a1701,20160929,3665,3676,3662,3710,3650,3687,3690,11,14,117828,4348508120,134898
843,a1701,20160930,3687,3690,3687,3749,3672,3749,3718,59,28,160590,5971454020,141848
844,a1701,20161010,3749,3718,3790,3790,3703,3752,3722,34,4,102068,3799536000,143462
845,a1701,20161011,3752,3722,3743,3758,3700,3712,3723,-10,1,161404,6009299340,158446
846,a1701,20161012,3712,3723,3703,3728,3624,3633,3674,-90,-49,216388,7950680280,163652
847,a1701,20161013,3633,3674,3638,3648,3612,3624,3627,-50,-47,193316,7012974380,189416
848,a1701,20161014,3624,3627,3627,3673,3625,3660,3651,33,24,146228,5340131380,179118
849,a1701,20161017,3660,3651,3660,3706,3643,3681,3679,30,28,197892,7281984800,190198
850,a1701,20161018,3681,3679,3689,3702,3659,3675,3676,-4,-3,147364,5417253300,197190
851,a1701,20161019,3675,3676,3666,3683,3640,3674,3664,-2,-12,205292,7521930920,202040
852,a1701,20161020,3674,3664,3670,3743,3669,3742,3703,78,39,283028,10482467820,187988
853,a1701,20161021,3742,3703,3740,3779,3695,3761,3741,58,38,253220,9474899360,185844
854,a1701,20161024,3761,3741,3761,3816,3741,3805,3779,64,38,220844,8347404300,189260
855,a1701,20161025,3805,3779,3812,3850,3751,3762,3791,-17,12,235956,8946568420,180274
856,a1701,20161026,3762,3791,3761,3890,3731,3876,3821,85,30,369214,14108013960,200072
857,a1701,20161027,3876,3821,3870,3918,3838,3865,3877,44,56,352974,13686778880,182732
858,a1701,20161028,3865,3877,3860,3886,3836,3851,3860,-26,-17,188714,7284519840,177668
859,a1701,20161031,3851,3860,3848,3866,3812,3823,3832,-37,-28,156268,5988361080,172280
860,a1701,20161101,3823,3832,3822,3883,3793,3839,3846,7,14,240198,9239978340,180428
861,a1701,20161102,3839,3846,3837,3860,3771,3785,3810,-61,-36,209204,7971059800,169914
862,a1701,20161103,3785,3810,3798,3820,3753,3768,3786,-42,-24,183790,6959562040,166466
863,a1701,20161104,3768,3786,3775,3801,3760,3762,3782,-24,-4,149672,5660647700,163616
864,a1701,20161107,3762,3782,3765,3855,3752,3832,3808,50,26,177398,6756953520,172224
865,a1701,20161108,3832,3808,3838,3860,3807,3844,3831,36,23,168238,6445338540,174504
866,a1701,20161109,3844,3831,3844,3875,3788,3810,3832,-21,1,202122,7747146460,164742
867,a1701,20161110,3810,3832,3816,3910,3793,3874,3852,42,20,301476,11615849840,169226
868,a1701,20161111,3874,3852,3866,3995,3858,3930,3930,78,78,377172,14823320460,169180
869,a1701,20161114,3930,3930,3910,3989,3734,3734,3832,-196,-98,313694,12020757040,124974
870,a1701,20161115,3734,3832,3731,3771,3656,3662,3711,-170,-121,206336,7657296880,109762
871,a1701,20161116,3662,3711,3667,3722,3666,3696,3695,-15,-16,167804,6200605900,120326
872,a1701,20161117,3696,3695,3695,3737,3686,3714,3714,19,19,173920,6459879560,118800
873,a1701,20161118,3714,3714,3719,3729,3686,3716,3706,2,-8,129216,4788915820,119308
874,a1701,20161121,3716,3706,3722,3794,3705,3771,3753,65,47,156892,5889476940,111658
875,a1701,20161122,3771,3753,3770,3829,3770,3815,3803,62,50,166600,6335846920,110280
876,a1701,20161123,3815,3803,3812,3885,3793,3842,3844,39,41,188176,7234015540,111168
877,a1701,20161124,3842,3844,3847,3890,3800,3816,3847,-28,3,203268,7820049600,101500
878,a1701,20161125,3816,3847,3823,3845,3771,3828,3812,-19,-35,155654,5934985520,92790
879,a1701,20161128,3828,3812,3844,3924,3816,3895,3870,83,58,168250,6511811260,89180
880,a1701,20161129,3895,3870,3883,4004,3866,3960,3942,90,72,230884,9101906300,75182
881,a1701,20161130,3960,3942,3952,3969,3835,3921,3912,-21,-30,218552,8549853420,65022
882,a1701,20161201,3921,3912,3931,4028,3931,3988,3984,76,72,114334,4556177440,64188
883,a1701,20161202,3988,3984,3984,4183,3968,4183,4087,199,103,130430,5331213180,80492
884,a1701,20161205,4183,4087,4232,4388,4219,4314,4316,227,229,152666,6590142280,79430
885,a1701,20161206,4314,4316,4316,4350,4280,4302,4311,-14,-5,53750,2317615840,69968
886,a1701,20161207,4302,4311,4322,4400,4293,4368,4342,57,31,43968,1909459380,64000
887,a1701,20161208,4368,4342,4368,4368,4300,4332,4323,-10,-19,26314,1137629580,61924
888,a1701,20161209,4332,4323,4333,4348,4302,4343,4327,20,4,23482,1016088780,58538
889,a1701,20161212,4343,4327,4326,4386,4326,4372,4366,45,39,31382,1370429160,53390
890,a1701,20161213,4372,4366,4370,4390,4342,4381,4373,15,7,15554,680216640,50592
891,a1701,20161214,4381,4373,4385,4388,4350,4358,4363,-15,-10,9558,417054760,48566
892,a1701,20161215,4358,4363,4352,4377,4346,4357,4363,-6,0,6386,278633140,47518
893,a1701,20161216,4357,4363,4350,4470,4350,4455,4426,92,63,15952,706179000,43634
894,a1701,20161219,4455,4426,4450,4454,4355,4384,4400,-42,-26,12668,557397740,39576
895,a1701,20161220,4384,4400,4350,4420,4350,4400,4395,0,-5,7422,326200240,37364
896,a1701,20161221,4400,4395,4380,4446,4380,4416,4419,21,24,8222,363373500,33030
897,a1701,20161222,4416,4419,4410,4439,4386,4388,4402,-31,-17,4958,218294420,30930
898,a1701,20161223,4388,4402,4385,4401,4366,4387,4378,-15,-24,2576,112787920,30492
899,a1701,20161226,4387,4378,4380,4411,4295,4295,4349,-83,-29,3980,173098640,28906
900,a1701,20161227,4295,4349,4265,4323,4251,4260,4277,-89,-72,1342,57398800,28298
901,a1701,20161228,4260,4277,4279,4288,4230,4237,4254,-40,-23,4454,189515460,27564
902,a1701,20161229,4237,4254,4237,4398,4223,4337,4328,83,74,4884,211380600,26930
903,a1701,20161230,4337,4328,4302,4388,4302,4361,4372,33,44,3158,138076520,24406
904,a1703,20160104,3491,3501,3489,3489,3436,3437,3455,-64,-46,36,1244060,176
905,a1703,20160105,3437,3455,3447,3454,3441,3441,3448,-14,-7,50,1724060,188
906,a1703,20160106,3441,3448,3420,3430,3420,3420,3428,-28,-20,34,1165800,218
907,a1703,20160107,3420,3428,3433,3444,3423,3436,3435,8,7,24,824400,226
908,a1703,20160108,3436,3435,3440,3446,3422,3436,3433,1,-2,36,1236100,242
909,a1703,20160111,3436,3433,3444,3444,3428,3428,3435,-5,2,18,618340,240
910,a1703,20160112,3428,3435,3433,3433,3310,3412,3386,-23,-49,22,745060,242
911,a1703,20160113,3412,3386,3425,3432,3425,3432,3427,46,41,10,342740,242
912,a1703,20160114,3432,3427,3428,3447,3428,3433,3434,6,7,8,274780,240
913,a1703,20160115,3433,3434,3435,3438,3435,3437,3436,3,2,10,343600,240
914,a1703,20160118,3437,3436,3438,3450,3438,3450,3441,14,5,8,275280,244
915,a1703,20160119,3450,3441,3473,3476,3459,3468,3467,27,26,18,624200,236
916,a1703,20160120,3468,3467,3470,3484,3468,3468,3473,1,6,32,1111580,222
917,a1703,20160121,3468,3473,3464,3472,3464,3469,3468,-4,-5,20,693660,212
918,a1703,20160122,3469,3468,3473,3489,3473,3489,3485,21,17,8,278800,212
919,a1703,20160125,3489,3485,3484,3499,3475,3476,3484,-9,-1,28,975520,206
920,a1703,20160126,3476,3484,3458,3460,3454,3460,3456,-24,-28,12,414780,206
921,a1703,20160127,3460,3456,3456,3456,3456,3456,3456,0,0,2,69120,206
922,a1703,20160128,3456,3456,3460,3463,3450,3450,3457,-6,1,18,622420,210
923,a1703,20160129,3450,3457,3449,3449,3449,3449,3449,-8,-8,2,68980,208
924,a1703,20160201,3449,3449,3456,3456,3456,3456,3456,7,7,2,69120,208
925,a1703,20160202,3456,3456,0,0,0,3456,3456,0,0,0,0,208
926,a1703,20160203,3456,3456,3455,3455,3425,3441,3450,-15,-6,32,1104300,210
927,a1703,20160204,3441,3450,3425,3430,3400,3407,3419,-43,-31,30,1025960,202
928,a1703,20160205,3407,3419,3399,3405,3397,3402,3400,-17,-19,16,544100,192
929,a1703,20160215,3402,3400,3404,3416,3404,3410,3410,10,10,6,204600,192
930,a1703,20160216,3410,3410,3410,3420,3409,3409,3415,-1,5,10,341540,196
931,a1703,20160217,3409,3415,3414,3415,3414,3415,3414,0,-1,4,136580,196
932,a1703,20160218,3415,3414,3406,3406,3385,3397,3389,-17,-25,32,1084480,194
933,a1703,20160219,3397,3389,3404,3407,3392,3392,3403,3,14,12,408360,192
934,a1703,20160222,3392,3403,3414,3442,3414,3442,3428,39,25,14,479920,190
935,a1703,20160223,3442,3428,3436,3436,3416,3421,3424,-7,-4,22,753440,192
936,a1703,20160224,3421,3424,3434,3450,3404,3420,3422,-4,-2,58,1985000,186
937,a1703,20160225,3420,3422,3423,3423,3411,3411,3418,-11,-4,6,205080,186
938,a1703,20160226,3411,3418,3417,3417,3415,3415,3416,-3,-2,4,136640,190
939,a1703,20160229,3415,3416,3412,3420,3356,3356,3391,-60,-25,14,474820,190
940,a1703,20160301,3356,3391,3369,3400,3365,3400,3377,9,-14,48,1621300,194
941,a1703,20160302,3400,3377,3411,3417,3408,3408,3411,31,34,14,477600,192
942,a1703,20160303,3408,3411,3445,3460,3439,3450,3450,39,39,16,552080,198
943,a1703,20160304,3450,3450,3450,3484,3450,3480,3470,30,20,18,624600,200
944,a1703,20160307,3480,3470,3481,3515,3474,3480,3490,10,20,20,698120,198
945,a1703,20160308,3480,3490,3495,3496,3478,3481,3487,-9,-3,12,418440,204
946,a1703,20160309,3481,3487,3495,3495,3474,3479,3485,-8,-2,10,348500,204
947,a1703,20160310,3479,3485,3478,3478,3474,3474,3477,-11,-8,8,278160,202
948,a1703,20160311,3474,3477,3454,3478,3450,3450,3461,-27,-16,20,692360,200
949,a1703,20160314,3450,3461,0,0,0,3461,3461,0,0,0,0,200
950,a1703,20160315,3461,3461,3446,3460,3427,3429,3447,-32,-14,18,620580,200
951,a1703,20160316,3429,3447,3430,3431,3413,3413,3423,-34,-24,10,342340,200
952,a1703,20160317,3413,3423,3435,3435,3435,3435,3435,12,12,2,68700,202
953,a1703,20160318,3435,3435,3477,3482,3477,3482,3479,47,44,4,139180,200
954,a1703,20160321,3482,3479,3494,3494,3471,3490,3486,11,7,56,1952260,196
955,a1703,20160322,3490,3486,3421,3523,3421,3523,3472,37,-14,4,138880,194
956,a1703,20160323,3523,3472,3545,3583,3545,3555,3562,83,90,18,641180,194
957,a1703,20160324,3555,3562,3565,3565,3558,3558,3561,-4,-1,4,142460,192
958,a1703,20160325,3558,3561,3570,3643,3570,3589,3601,28,40,44,1584560,196
959,a1703,20160328,3589,3601,3604,3612,3586,3586,3599,-15,-2,22,791920,202
960,a1703,20160329,3586,3599,3560,3560,3533,3533,3543,-66,-56,22,779500,214
961,a1703,20160330,3533,3543,3544,3546,3503,3503,3520,-40,-23,28,985860,218
962,a1703,20160331,3503,3520,3502,3502,3490,3490,3498,-30,-22,6,209880,218
963,a1703,20160401,3490,3498,3442,3442,3442,3442,3442,-56,-56,2,68840,220
964,a1703,20160405,3442,3442,0,0,0,3435,3435,-7,-7,0,0,220
965,a1703,20160406,3435,3435,3421,3421,3390,3390,3402,-45,-33,8,272220,226
966,a1703,20160407,3390,3402,3395,3423,3389,3390,3399,-12,-3,32,1087920,226
967,a1703,20160408,3390,3399,0,0,0,3396,3396,-3,-3,0,0,226
968,a1703,20160411,3396,3396,3410,3411,3410,3411,3410,15,14,4,136420,226
969,a1703,20160412,3411,3410,3473,3473,3397,3420,3428,10,18,16,548620,222
970,a1703,20160413,3420,3428,3437,3557,3436,3436,3466,8,38,40,1386500,224
971,a1703,20160414,3436,3466,3435,3466,3435,3464,3457,-2,-9,52,1797780,182
972,a1703,20160415,3464,3457,3453,3453,3452,3453,3452,-4,-5,6,207160,178
973,a1703,20160418,3453,3452,3553,3553,3483,3496,3498,44,46,16,559800,172
974,a1703,20160419,3496,3498,3510,3531,3466,3524,3513,26,15,44,1546100,140
975,a1703,20160420,3524,3513,3548,3653,3534,3653,3623,140,110,86,3116620,94
976,a1703,20160421,3653,3623,3670,3670,3670,3670,3670,47,47,4,146800,94
977,a1703,20160422,3670,3670,3810,3870,3666,3718,3796,48,126,50,1898020,90
978,a1703,20160425,3718,3796,3734,3788,3645,3731,3730,-65,-66,14,522280,92
979,a1703,20160426,3731,3730,0,0,0,3730,3730,0,0,0,0,92
980,a1703,20160427,3730,3730,0,0,0,3730,3730,0,0,0,0,92
981,a1703,20160428,3730,3730,3679,3684,3656,3656,3674,-74,-56,30,1102460,76
982,a1703,20160429,3656,3674,3679,3710,3646,3646,3681,-28,7,18,662700,76
983,a1703,20160503,3646,3681,0,0,0,3716,3716,35,35,0,0,76
984,a1703,20160504,3716,3716,3758,3758,3754,3754,3754,38,38,22,825960,98
985,a1703,20160505,3754,3754,3681,3681,3673,3673,3678,-81,-76,8,294300,98
986,a1703,20160506,3673,3678,3679,3679,3568,3568,3631,-110,-47,24,871540,98
987,a1703,20160509,3568,3631,0,0,0,3600,3600,-31,-31,0,0,98
988,a1703,20160510,3600,3600,0,0,0,3572,3572,-28,-28,0,0,98
989,a1703,20160511,3572,3572,0,0,0,3701,3701,129,129,0,0,98
990,a1703,20160512,3701,3701,3681,3733,3681,3733,3707,32,6,42,1557200,98
991,a1703,20160513,3733,3707,3645,3650,3645,3645,3647,-62,-60,30,1094320,88
992,a1703,20160516,3645,3647,3633,3827,3633,3827,3730,180,83,4,149200,90
993,a1703,20160517,3827,3730,3709,3721,3706,3721,3710,-9,-20,10,371080,92
994,a1703,20160518,3721,3710,3750,3783,3715,3762,3758,52,48,10,375800,92
995,a1703,20160519,3762,3758,0,0,0,3758,3758,0,0,0,0,92
996,a1703,20160520,3758,3758,3763,3763,3736,3757,3752,-1,-6,6,225120,92
997,a1703,20160523,3757,3752,3714,3714,3714,3714,3714,-38,-38,6,222840,92
998,a1703,20160524,3714,3714,3645,3645,3645,3645,3645,-69,-69,4,145800,92
999,a1703,20160525,3645,3645,3650,3650,3650,3650,3650,5,5,2,73000,94
1000,a1703,20160526,3650,3650,0,0,0,3706,3706,56,56,0,0,94
1001,a1703,20160527,3706,3706,0,0,0,3706,3706,0,0,0,0,94
1002,a1703,20160530,3706,3706,3706,3820,3678,3767,3736,61,30,16,597780,90
1003,a1703,20160531,3767,3736,3770,3796,3737,3737,3762,1,26,12,451480,90
1004,a1703,20160601,3737,3762,0,0,0,3762,3762,0,0,0,0,90
1005,a1703,20160602,3762,3762,0,0,0,3762,3762,0,0,0,0,90
1006,a1703,20160603,3762,3762,3786,3786,3786,3786,3786,24,24,6,227160,90
1007,a1703,20160606,3786,3786,3788,3807,3788,3807,3794,21,8,38,1441960,86
1008,a1703,20160607,3807,3794,3810,3810,3810,3810,3810,16,16,4,152400,82
1009,a1703,20160608,3810,3810,0,0,0,3810,3810,0,0,0,0,82
1010,a1703,20160613,3810,3810,0,0,0,3943,3943,133,133,0,0,82
1011,a1703,20160614,3943,3943,0,0,0,3943,3943,0,0,0,0,82
1012,a1703,20160615,3943,3943,3852,3892,3852,3892,3867,-51,-76,6,232040,86
1013,a1703,20160616,3892,3867,3871,3871,3871,3871,3871,4,4,2,77420,88
1014,a1703,20160617,3871,3871,3786,3819,3786,3819,3794,-52,-77,8,303540,90
1015,a1703,20160620,3819,3794,3845,3866,3828,3828,3846,34,52,6,230780,90
1016,a1703,20160621,3828,3846,3861,3895,3843,3853,3869,7,23,50,1934720,94
1017,a1703,20160622,3853,3869,3834,3834,3823,3825,3826,-44,-43,10,382680,94
1018,a1703,20160623,3825,3826,0,0,0,3826,3826,0,0,0,0,94
1019,a1703,20160624,3826,3826,3870,3870,3870,3870,3870,44,44,2,77400,94
1020,a1703,20160627,3870,3870,3886,3886,3873,3873,3879,3,9,4,155180,94
1021,a1703,20160628,3873,3879,3943,3970,3909,3937,3936,58,57,18,708540,92
1022,a1703,20160629,3937,3936,3933,3942,3932,3932,3934,-4,-2,8,314780,88
1023,a1703,20160630,3932,3934,3989,3989,3956,3956,3978,22,44,8,318240,86
1024,a1703,20160701,3956,3978,0,0,0,3978,3978,0,0,0,0,86
1025,a1703,20160704,3978,3978,4005,4005,3971,3991,3990,13,12,12,478860,84
1026,a1703,20160705,3991,3990,0,0,0,3942,3942,-48,-48,0,0,84
1027,a1703,20160706,3942,3942,3924,4126,3828,4126,3959,184,17,6,237560,82
1028,a1703,20160707,4126,3959,3832,3832,3801,3801,3822,-158,-137,10,382220,78
1029,a1703,20160708,3801,3822,0,0,0,3821,3821,-1,-1,0,0,78
1030,a1703,20160711,3821,3821,3837,3837,3837,3837,3837,16,16,2,76740,80
1031,a1703,20160712,3837,3837,0,0,0,3837,3837,0,0,0,0,80
1032,a1703,20160713,3837,3837,0,0,0,3850,3850,13,13,0,0,80
1033,a1703,20160714,3850,3850,3898,3898,3898,3898,3898,48,48,6,233880,82
1034,a1703,20160715,3898,3898,3902,3934,3862,3862,3911,-36,13,26,1016860,82
1035,a1703,20160718,3862,3911,0,0,0,3911,3911,0,0,0,0,82
1036,a1703,20160719,3911,3911,0,0,0,3911,3911,0,0,0,0,82
1037,a1703,20160720,3911,3911,0,0,0,3911,3911,0,0,0,0,82
1038,a1703,20160721,3911,3911,0,0,0,3911,3911,0,0,0,0,82
1039,a1703,20160722,3911,3911,3770,3770,3727,3730,3740,-181,-171,36,1346660,98
1040,a1703,20160725,3730,3740,3689,3690,3673,3679,3682,-61,-58,16,589240,92
1041,a1703,20160726,3679,3682,0,0,0,3682,3682,0,0,0,0,92
1042,a1703,20160727,3682,3682,3708,3708,3708,3708,3708,26,26,2,74160,94
1043,a1703,20160728,3708,3708,3681,3690,3681,3690,3684,-18,-24,6,221040,92
1044,a1703,20160729,3690,3684,3651,3695,3636,3695,3668,11,-16,20,733680,92
1045,a1703,20160801,3695,3668,0,0,0,3668,3668,0,0,0,0,92
1046,a1703,20160802,3668,3668,0,0,0,3656,3656,-12,-12,0,0,92
1047,a1703,20160803,3656,3656,3632,3641,3632,3641,3636,-15,-20,4,145460,96
1048,a1703,20160804,3641,3636,3662,3669,3620,3655,3648,19,12,100,3648120,116
1049,a1703,20160805,3655,3648,3688,3688,3688,3688,3688,40,40,6,221280,112
1050,a1703,20160808,3688,3688,3705,3729,3682,3724,3705,36,17,20,741120,104
1051,a1703,20160809,3724,3705,3706,3706,3687,3687,3696,-18,-9,4,147860,104
1052,a1703,20160810,3687,3696,3751,3751,3750,3750,3750,54,54,4,150020,102
1053,a1703,20160811,3750,3750,3761,3761,3761,3761,3761,11,11,2,75220,104
1054,a1703,20160812,3761,3761,0,0,0,3767,3767,6,6,0,0,104
1055,a1703,20160815,3767,3767,3748,3748,3746,3746,3747,-21,-20,6,224820,100
1056,a1703,20160816,3746,3747,3825,3829,3825,3829,3827,82,80,4,153080,98
1057,a1703,20160817,3829,3827,3843,3867,3843,3867,3855,40,28,4,154200,98
1058,a1703,20160818,3867,3855,0,0,0,3872,3872,17,17,0,0,98
1059,a1703,20160819,3872,3872,3862,3862,3862,3862,3862,-10,-10,2,77240,96
1060,a1703,20160822,3862,3862,3875,3875,3872,3872,3873,10,11,6,232400,96
1061,a1703,20160823,3872,3873,0,0,0,3873,3873,0,0,0,0,96
1062,a1703,20160824,3873,3873,0,0,0,3873,3873,0,0,0,0,96
1063,a1703,20160825,3873,3873,3822,3822,3815,3815,3818,-58,-55,4,152740,96
1064,a1703,20160826,3815,3818,0,0,0,3818,3818,0,0,0,0,96
1065,a1703,20160829,3818,3818,0,0,0,3818,3818,0,0,0,0,96
1066,a1703,20160830,3818,3818,3780,3780,3780,3780,3780,-38,-38,2,75600,96
1067,a1703,20160831,3780,3780,3781,3781,3770,3770,3775,-10,-5,4,151020,94
1068,a1703,20160901,3770,3775,3650,3680,3650,3673,3671,-102,-104,22,807700,80
1069,a1703,20160902,3673,3671,3723,3724,3650,3650,3687,-21,16,12,442480,78
1070,a1703,20160905,3650,3687,3650,3650,3614,3614,3639,-73,-48,28,1019020,78
1071,a1703,20160906,3614,3639,0,0,0,3639,3639,0,0,0,0,78
1072,a1703,20160907,3639,3639,3645,3664,3642,3664,3646,25,7,14,510500,74
1073,a1703,20160908,3664,3646,0,0,0,3646,3646,0,0,0,0,74
1074,a1703,20160909,3646,3646,0,0,0,3646,3646,0,0,0,0,74
1075,a1703,20160912,3646,3646,0,0,0,3646,3646,0,0,0,0,74
1076,a1703,20160913,3646,3646,3695,3695,3695,3695,3695,49,49,2,73900,72
1077,a1703,20160914,3695,3695,0,0,0,3695,3695,0,0,0,0,72
1078,a1703,20160919,3695,3695,0,0,0,3809,3809,114,114,0,0,72
1079,a1703,20160920,3809,3809,3834,3834,3834,3834,3834,25,25,2,76680,74
1080,a1703,20160921,3834,3834,3763,3799,3763,3799,3781,-35,-53,4,151240,70
1081,a1703,20160922,3799,3781,0,0,0,3781,3781,0,0,0,0,70
1082,a1703,20160923,3781,3781,0,0,0,3781,3781,0,0,0,0,70
1083,a1703,20160926,3781,3781,3775,3775,3775,3775,3775,-6,-6,2,75500,70
1084,a1703,20160927,3775,3775,3728,3728,3728,3728,3728,-47,-47,2,74560,70
1085,a1703,20160928,3728,3728,3766,3766,3726,3726,3746,-2,18,4,149840,68
1086,a1703,20160929,3726,3746,0,0,0,3746,3746,0,0,0,0,68
1087,a1703,20160930,3746,3746,3706,3719,3705,3719,3717,-27,-29,44,1635820,104
1088,a1703,20161010,3719,3717,0,0,0,3737,3737,20,20,0,0,104
1089,a1703,20161011,3737,3737,3776,3776,3736,3739,3746,2,9,30,1123800,96
1090,a1703,20161012,3739,3746,3730,3730,3670,3670,3708,-76,-38,12,445020,92
1091,a1703,20161013,3670,3708,3686,3686,3686,3686,3686,-22,-22,2,73720,90
1092,a1703,20161014,3686,3686,0,0,0,3686,3686,0,0,0,0,90
1093,a1703,20161017,3686,3686,3681,3694,3681,3692,3684,6,-2,30,1105380,76
1094,a1703,20161018,3692,3684,3683,3683,3676,3676,3678,-8,-6,6,220700,70
1095,a1703,20161019,3676,3678,3662,3670,3662,3670,3666,-8,-12,4,146640,70
1096,a1703,20161020,3670,3666,0,0,0,3705,3705,39,39,0,0,70
1097,a1703,20161021,3705,3705,0,0,0,3705,3705,0,0,0,0,70
1098,a1703,20161024,3705,3705,3773,3773,3773,3773,3773,68,68,2,75460,70
1099,a1703,20161025,3773,3773,3838,3838,3800,3800,3812,27,39,6,228760,68
1100,a1703,20161026,3800,3812,3796,3919,3796,3919,3829,107,17,10,382980,72
1101,a1703,20161027,3919,3829,3906,3940,3906,3919,3936,90,107,70,2755220,130
1102,a1703,20161028,3919,3936,3895,3895,3895,3895,3895,-41,-41,2,77900,130
1103,a1703,20161031,3895,3895,0,0,0,3895,3895,0,0,0,0,130
1104,a1703,20161101,3895,3895,3859,3873,3845,3870,3861,-25,-34,142,5482940,162
1105,a1703,20161102,3870,3861,3831,3831,3764,3793,3794,-68,-67,28,1062460,156
1106,a1703,20161103,3793,3794,3761,3761,3761,3761,3761,-33,-33,2,75220,154
1107,a1703,20161104,3761,3761,3771,3782,3771,3782,3776,21,15,8,302120,150
1108,a1703,20161107,3782,3776,0,0,0,3776,3776,0,0,0,0,150
1109,a1703,20161108,3776,3776,0,0,0,3792,3792,16,16,0,0,150
1110,a1703,20161109,3792,3792,0,0,0,3792,3792,0,0,0,0,150
1111,a1703,20161110,3792,3792,3875,3898,3805,3898,3845,106,53,36,1384540,148
1112,a1703,20161111,3898,3845,3907,3947,3827,3917,3903,72,58,90,3512820,146
1113,a1703,20161114,3917,3903,3943,3951,3730,3800,3816,-103,-87,128,4884480,122
1114,a1703,20161115,3800,3816,3680,3816,3680,3740,3765,-76,-51,38,1430760,138
1115,a1703,20161116,3740,3765,3750,3750,3750,3750,3750,-15,-15,2,75000,138
1116,a1703,20161117,3750,3750,3758,3758,3758,3758,3758,8,8,2,75160,136
1117,a1703,20161118,3758,3758,3735,3736,3733,3736,3735,-22,-23,16,597640,142
1118,a1703,20161121,3736,3735,3748,3785,3721,3784,3763,49,28,114,4289980,200
1119,a1703,20161122,3784,3763,3790,3814,3788,3788,3798,25,35,56,2127100,204
1120,a1703,20161123,3788,3798,3797,3820,3787,3798,3799,0,1,216,8207500,294
1121,a1703,20161124,3798,3799,3796,3835,3779,3796,3802,-3,3,58,2205220,290
1122,a1703,20161125,3796,3802,3811,3812,3750,3800,3796,-2,-6,24,911120,292
1123,a1703,20161128,3800,3796,3790,3850,3790,3850,3814,54,18,34,1296820,290
1124,a1703,20161129,3850,3814,3845,3930,3806,3930,3878,116,64,26,1008320,284
1125,a1703,20161130,3930,3878,3860,3895,3830,3889,3867,11,-11,18,696200,286
1126,a1703,20161201,3889,3867,3955,3970,3868,3931,3922,64,55,30,1176700,280
1127,a1703,20161202,3931,3922,3965,4072,3931,4072,3999,150,77,80,3199780,280
1128,a1703,20161205,4072,3999,4057,4136,4042,4135,4091,136,92,90,3682760,284
1129,a1703,20161206,4135,4091,4198,4211,4147,4190,4183,99,92,134,5605860,302
1130,a1703,20161207,4190,4183,4193,4274,4191,4249,4220,66,37,34,1434940,288
1131,a1703,20161208,4249,4220,4236,4240,4110,4135,4160,-85,-60,96,3993680,330
1132,a1703,20161209,4135,4160,4150,4150,4081,4099,4107,-61,-53,64,2628660,370
1133,a1703,20161212,4099,4107,4102,4130,4092,4093,4107,-14,0,86,3532600,424
1134,a1703,20161213,4093,4107,4101,4110,4095,4100,4101,-7,-6,294,12058700,508
1135,a1703,20161214,4100,4101,4109,4110,4024,4039,4070,-62,-31,104,4233240,518
1136,a1703,20161215,4039,4070,4038,4077,4036,4076,4058,6,-12,24,974080,518
1137,a1703,20161216,4076,4058,4068,4208,4068,4206,4172,148,114,462,19277660,554
1138,a1703,20161219,4206,4172,4160,4221,4160,4188,4203,16,31,458,19249780,762
1139,a1703,20161220,4188,4203,4199,4206,4176,4176,4196,-27,-7,114,4783740,786
1140,a1703,20161221,4176,4196,4198,4256,4198,4250,4219,54,23,384,16202540,1090
1141,a1703,20161222,4250,4219,4247,4259,4181,4181,4209,-38,-10,20,841900,1086
1142,a1703,20161223,4181,4209,4222,4229,4201,4201,4227,-8,18,38,1606280,1090
1143,a1703,20161226,4201,4227,4219,4219,4053,4160,4169,-67,-58,86,3585880,1120
1144,a1703,20161227,4160,4169,4155,4155,4090,4137,4137,-32,-32,14,579300,1112
1145,a1703,20161228,4137,4137,4220,4220,4150,4151,4167,14,30,8,333420,1112
1146,a1703,20161229,4151,4167,4038,4250,4038,4245,4165,78,-2,296,12330680,1102
1147,a1703,20161230,4245,4165,4201,4217,4201,4201,4205,36,40,8,336420,1098
1148,a1705,20160104,3514,3517,3518,3518,3448,3455,3473,-62,-44,146,5071500,640
1149,a1705,20160105,3455,3473,3460,3469,3452,3459,3459,-14,-14,278,9617740,778
1150,a1705,20160106,3459,3459,3461,3462,3422,3428,3432,-31,-27,294,10091900,850
1151,a1705,20160107,3428,3432,3430,3446,3423,3433,3438,1,6,148,5089040,912
1152,a1705,20160108,3433,3438,3439,3451,3430,3450,3443,12,5,108,3718600,948
1153,a1705,20160111,3450,3443,3450,3457,3427,3427,3437,-16,-6,110,3781400,966
1154,a1705,20160112,3427,3437,3433,3434,3425,3432,3430,-5,-7,48,1646660,962
1155,a1705,20160113,3432,3430,3432,3457,3432,3445,3445,15,15,90,3101180,958
1156,a1705,20160114,3445,3445,3437,3442,3437,3442,3438,-3,-7,18,619000,960
1157,a1705,20160115,3442,3438,3439,3442,3434,3434,3439,-4,1,16,550260,954
1158,a1705,20160118,3434,3439,3443,3457,3435,3453,3446,14,7,94,3240120,978
1159,a1705,20160119,3453,3446,3458,3503,3458,3494,3480,48,34,222,7726720,914
1160,a1705,20160120,3494,3480,3582,3582,3481,3481,3488,1,8,190,6627520,898
1161,a1705,20160121,3481,3488,3474,3483,3472,3478,3479,-10,-9,70,2435340,870
1162,a1705,20160122,3478,3479,3484,3495,3466,3492,3490,13,11,70,2443140,844
1163,a1705,20160125,3492,3490,3476,3500,3476,3485,3485,-5,-5,64,2230660,872
1164,a1705,20160126,3485,3485,3470,3479,3470,3473,3472,-12,-13,64,2222640,868
1165,a1705,20160127,3473,3472,3475,3479,3469,3469,3471,-3,-1,60,2083140,840
1166,a1705,20160128,3469,3471,3456,3466,3450,3451,3457,-20,-14,192,6637440,906
1167,a1705,20160129,3451,3457,3457,3459,3437,3450,3450,-7,-7,48,1656380,910
1168,a1705,20160201,3450,3450,3436,3466,3421,3449,3454,-1,4,56,1934580,908
1169,a1705,20160202,3449,3454,3403,3458,3403,3456,3448,2,-6,50,1724080,922
1170,a1705,20160203,3456,3448,3445,3450,3423,3450,3443,2,-5,92,3168400,930
1171,a1705,20160204,3450,3443,3431,3436,3408,3414,3425,-29,-18,90,3083380,930
1172,a1705,20160205,3414,3425,3401,3460,3386,3409,3419,-16,-6,270,9232200,870
1173,a1705,20160215,3409,3419,3437,3438,3397,3405,3414,-14,-5,120,4097600,884
1174,a1705,20160216,3405,3414,3398,3420,3359,3418,3410,4,-4,178,6070500,972
1175,a1705,20160217,3418,3410,3394,3419,3394,3416,3413,6,3,78,2662300,980
1176,a1705,20160218,3416,3413,3414,3422,3412,3416,3415,3,2,254,8676380,1006
1177,a1705,20160219,3416,3415,3424,3426,3412,3424,3419,9,4,106,3624680,1038
1178,a1705,20160222,3424,3419,3430,3448,3419,3440,3437,21,18,348,11963940,1086
1179,a1705,20160223,3440,3437,3443,3443,3429,3440,3437,3,0,110,3781020,1128
1180,a1705,20160224,3440,3437,3440,3450,3420,3424,3437,-13,0,208,7149220,1104
1181,a1705,20160225,3424,3437,3422,3436,3415,3415,3426,-22,-11,76,2603820,1096
1182,a1705,20160226,3415,3426,3407,3428,3407,3418,3420,-8,-6,80,2736780,1068
1183,a1705,20160229,3418,3420,3418,3424,3369,3377,3388,-43,-32,282,9556260,1058
1184,a1705,20160301,3377,3388,3372,3416,3372,3410,3400,22,12,166,5645140,1032
1185,a1705,20160302,3410,3400,3414,3436,3412,3425,3424,25,24,114,3903860,1046
1186,a1705,20160303,3425,3424,3431,3472,3431,3466,3455,42,31,170,5874840,1070
1187,a1705,20160304,3466,3455,3471,3490,3452,3480,3477,25,22,174,6051440,1122
1188,a1705,20160307,3480,3477,3491,3526,3478,3493,3501,16,24,314,10993800,1168
1189,a1705,20160308,3493,3501,3501,3516,3476,3489,3496,-12,-5,104,3636700,1178
1190,a1705,20160309,3489,3496,3495,3500,3468,3473,3478,-23,-18,120,4174600,1154
1191,a1705,20160310,3473,3478,3478,3484,3470,3470,3475,-8,-3,22,764540,1154
1192,a1705,20160311,3470,3475,3466,3472,3452,3461,3461,-14,-14,124,4291900,1216
1193,a1705,20160314,3461,3461,3468,3481,3466,3469,3473,8,12,280,9724960,1398
1194,a1705,20160315,3469,3473,3456,3470,3430,3434,3449,-39,-24,398,13730340,1598
1195,a1705,20160316,3434,3449,3422,3436,3397,3410,3413,-39,-36,322,10992120,1796
1196,a1705,20160317,3410,3413,3412,3427,3411,3425,3421,12,8,228,7800460,1778
1197,a1705,20160318,3425,3421,3448,3503,3433,3488,3473,67,52,1224,42516880,1796
1198,a1705,20160321,3488,3473,3495,3495,3471,3480,3481,7,8,554,19285680,1896
1199,a1705,20160322,3480,3481,3490,3544,3486,3538,3521,57,40,942,33177100,2032
1200,a1705,20160323,3538,3521,3536,3599,3536,3559,3570,38,49,1068,38133840,2256
1201,a1705,20160324,3559,3570,3545,3594,3520,3561,3570,-9,0,1296,46278140,2914
1202,a1705,20160325,3561,3570,3554,3630,3554,3626,3611,56,41,834,30118660,3130
1203,a1705,20160328,3626,3611,3639,3649,3591,3591,3625,-20,14,968,35095380,3036
1204,a1705,20160329,3591,3625,3591,3597,3551,3555,3577,-70,-48,882,31554340,3130
1205,a1705,20160330,3555,3577,3561,3614,3544,3558,3567,-19,-10,1584,56505720,3088
1206,a1705,20160331,3558,3567,3561,3563,3502,3515,3524,-52,-43,1110,39121040,3098
1207,a1705,20160401,3515,3524,3512,3523,3440,3441,3476,-83,-48,1154,40114540,3154
1208,a1705,20160405,3441,3476,3450,3450,3431,3439,3441,-37,-35,1428,49149320,3238
1209,a1705,20160406,3439,3441,3431,3431,3394,3403,3412,-38,-29,1078,36782260,3580
1210,a1705,20160407,3403,3412,3410,3426,3407,3415,3417,3,5,684,23374940,3596
1211,a1705,20160408,3415,3417,3413,3425,3409,3413,3414,-4,-3,398,13590500,3472
1212,a1705,20160411,3413,3414,3418,3455,3417,3431,3435,17,21,752,25834740,3466
1213,a1705,20160412,3431,3435,3438,3462,3433,3454,3449,19,14,618,21320200,3456
1214,a1705,20160413,3454,3449,3460,3486,3450,3453,3467,4,18,3218,111593740,4410
1215,a1705,20160414,3453,3467,3455,3511,3455,3484,3487,17,20,1378,48059180,4428
1216,a1705,20160415,3484,3487,3495,3499,3469,3475,3481,-12,-6,868,30219720,4474
1217,a1705,20160418,3475,3481,3469,3534,3459,3522,3500,41,19,1018,35636640,4536
1218,a1705,20160419,3522,3500,3527,3556,3520,3543,3540,43,40,1408,49845520,4666
1219,a1705,20160420,3543,3540,3546,3681,3546,3681,3643,141,103,2708,98660040,5060
1220,a1705,20160421,3681,3643,3647,3788,3647,3788,3719,145,76,1394,51852320,5108
1221,a1705,20160422,3788,3719,3819,3900,3655,3721,3812,2,93,5050,192516580,4956
1222,a1705,20160425,3721,3812,3714,3875,3714,3765,3796,-47,-16,3932,149264320,5194
1223,a1705,20160426,3765,3796,3729,3820,3729,3764,3778,-32,-18,2020,76319040,5166
1224,a1705,20160427,3764,3778,3791,3829,3737,3745,3765,-33,-13,954,35919720,5156
1225,a1705,20160428,3745,3765,3759,3759,3624,3674,3699,-91,-66,1806,66818360,4974
1226,a1705,20160429,3674,3699,3692,3728,3656,3657,3692,-42,-7,906,33454800,4948
1227,a1705,20160503,3657,3692,3661,3763,3661,3762,3735,70,43,2026,75674520,5506
1228,a1705,20160504,3762,3735,3739,3793,3692,3705,3724,-30,-11,1126,41932260,5560
1229,a1705,20160505,3705,3724,3713,3724,3670,3673,3701,-51,-23,1076,39824200,5624
1230,a1705,20160506,3673,3701,3696,3700,3578,3581,3611,-120,-90,1998,72161980,5568
1231,a1705,20160509,3581,3611,3576,3648,3575,3605,3610,-6,-1,1528,55170360,5662
1232,a1705,20160510,3605,3610,3592,3601,3546,3598,3573,-12,-37,1292,46175620,5320
1233,a1705,20160511,3598,3573,3608,3751,3600,3751,3721,178,148,2658,98909140,5226
1234,a1705,20160512,3751,3721,3746,3795,3699,3736,3745,15,24,1970,73787120,5506
1235,a1705,20160513,3736,3745,3724,3763,3619,3651,3681,-94,-64,1704,62725620,5016
1236,a1705,20160516,3651,3681,3632,3719,3497,3697,3630,16,-51,1714,62220140,4980
1237,a1705,20160517,3697,3630,3690,3740,3690,3740,3718,110,88,1698,63143960,5306
1238,a1705,20160518,3740,3718,3729,3825,3720,3747,3774,29,56,1778,67110000,5444
1239,a1705,20160519,3747,3774,3736,3779,3705,3769,3752,-5,-22,1940,72806060,5434
1240,a1705,20160520,3769,3752,3742,3759,3726,3752,3744,0,-8,914,34227200,5448
1241,a1705,20160523,3752,3744,3776,3797,3696,3700,3729,-44,-15,1924,71762800,5554
1242,a1705,20160524,3700,3729,3700,3712,3597,3602,3649,-127,-80,2646,96565780,5530
1243,a1705,20160525,3602,3649,3599,3644,3585,3627,3619,-22,-30,1350,48866760,5474
1244,a1705,20160526,3627,3619,3645,3707,3636,3707,3676,88,57,1650,60663660,5326
1245,a1705,20160527,3707,3676,3710,3727,3651,3706,3691,30,15,1632,60248300,5418
1246,a1705,20160530,3706,3691,3693,3783,3691,3760,3745,69,54,1586,59409300,5498
1247,a1705,20160531,3760,3745,3725,3794,3675,3752,3743,7,-2,3502,131109120,5854
1248,a1705,20160601,3752,3743,3768,3814,3710,3747,3774,4,31,2092,78964460,6038
1249,a1705,20160602,3747,3774,3746,3828,3728,3787,3797,13,23,1334,50652140,5808
1250,a1705,20160603,3787,3797,3788,3830,3770,3788,3800,-9,3,1810,68787460,5922
1251,a1705,20160606,3788,3800,3800,3811,3778,3805,3795,5,-5,2086,79165000,6090
1252,a1705,20160607,3805,3795,3815,3825,3783,3815,3798,20,3,1888,71717160,5756
1253,a1705,20160608,3815,3798,3805,3816,3778,3810,3802,12,4,1866,70960260,5396
1254,a1705,20160613,3810,3802,3852,3966,3852,3920,3928,118,126,2058,80847740,5552
1255,a1705,20160614,3920,3928,3920,3948,3836,3853,3873,-75,-55,2404,93120300,6076
1256,a1705,20160615,3853,3873,3863,3879,3810,3839,3841,-34,-32,2838,109012120,6650
1257,a1705,20160616,3839,3841,3876,3876,3782,3795,3821,-46,-20,3706,141613640,7234
1258,a1705,20160617,3795,3821,3800,3830,3761,3823,3805,2,-16,2510,95513540,7026
1259,a1705,20160620,3823,3805,3825,3852,3805,3832,3828,27,23,1354,51838620,7096
1260,a1705,20160621,3832,3828,3821,3867,3810,3832,3842,4,14,1098,42194460,7104
1261,a1705,20160622,3832,3842,3829,3833,3780,3833,3809,-9,-33,918,34969060,7014
1262,a1705,20160623,3833,3809,3823,3867,3812,3827,3841,18,32,1182,45404760,6792
1263,a1705,20160624,3827,3841,3825,3866,3801,3801,3836,-40,-5,1626,62378980,6662
1264,a1705,20160627,3801,3836,3788,3882,3771,3878,3843,42,7,952,36590820,6530
1265,a1705,20160628,3878,3843,3861,3964,3861,3941,3916,98,73,2554,100014960,6410
1266,a1705,20160629,3941,3916,3940,3950,3895,3908,3918,-8,2,1530,59960220,6246
1267,a1705,20160630,3908,3918,3910,3975,3903,3961,3947,43,29,3470,136963420,7958
1268,a1705,20160701,3961,3947,3953,4086,3924,3972,3992,25,45,2412,96295000,8004
1269,a1705,20160704,3972,3992,3972,4023,3965,3981,3994,-11,2,1876,74931660,8136
1270,a1705,20160705,3981,3994,3980,3998,3890,3945,3942,-49,-52,2176,85796880,8022
1271,a1705,20160706,3945,3942,3940,3965,3830,3861,3883,-81,-59,2618,101662240,8304
1272,a1705,20160707,3861,3883,3848,3917,3803,3829,3849,-54,-34,2928,112700640,8424
1273,a1705,20160708,3829,3849,3829,3875,3775,3787,3808,-62,-41,3564,135724680,8622
1274,a1705,20160711,3787,3808,3787,3885,3787,3835,3836,27,28,2250,86319920,8534
1275,a1705,20160712,3835,3836,3844,3858,3815,3842,3839,6,3,1368,52522020,8606
1276,a1705,20160713,3842,3839,3832,3914,3829,3906,3880,67,41,2366,91824320,8272
1277,a1705,20160714,3906,3880,3944,3950,3895,3943,3933,63,53,1856,73003060,8456
1278,a1705,20160715,3943,3933,3940,3950,3862,3889,3892,-44,-41,1950,75903260,8402
1279,a1705,20160718,3889,3892,3863,3901,3838,3847,3873,-45,-19,1026,39737780,8452
1280,a1705,20160719,3847,3873,3826,3880,3826,3854,3862,-19,-11,1400,54075540,8638
1281,a1705,20160720,3854,3862,3851,3856,3788,3830,3812,-32,-50,2612,99573480,9190
1282,a1705,20160721,3830,3812,3818,3834,3781,3793,3803,-19,-9,3932,149536440,9786
1283,a1705,20160722,3793,3803,3790,3800,3716,3728,3751,-75,-52,5230,196223700,10480
1284,a1705,20160725,3728,3751,3716,3730,3674,3703,3697,-48,-54,5962,220426940,9068
1285,a1705,20160726,3703,3697,3706,3721,3682,3713,3695,16,-2,2224,82190960,8654
1286,a1705,20160727,3713,3695,3686,3727,3684,3704,3707,9,12,1306,48418300,8512
1287,a1705,20160728,3704,3707,3719,3736,3687,3705,3711,-2,4,1504,55816300,8496
1288,a1705,20160729,3705,3711,3708,3709,3641,3659,3678,-52,-33,1794,65983820,8580
1289,a1705,20160801,3659,3678,3678,3733,3659,3703,3704,25,26,1610,59639660,8304
1290,a1705,20160802,3703,3704,3702,3715,3651,3680,3676,-24,-28,2402,88307000,8568
1291,a1705,20160803,3680,3676,3678,3700,3665,3687,3683,11,7,1370,50461400,8598
1292,a1705,20160804,3687,3683,3687,3705,3655,3704,3677,21,-6,2030,74663020,8674
1293,a1705,20160805,3704,3677,3704,3740,3688,3723,3717,46,40,2270,84377820,8616
1294,a1705,20160808,3723,3717,3717,3763,3717,3725,3748,8,31,1790,67094080,8892
1295,a1705,20160809,3725,3748,3733,3751,3706,3742,3735,-6,-13,2336,87254980,8644
1296,a1705,20160810,3742,3735,3742,3789,3733,3783,3775,48,40,3164,119454860,9926
1297,a1705,20160811,3783,3775,3778,3786,3756,3760,3767,-15,-8,1638,61707580,10116
1298,a1705,20160812,3760,3767,3760,3788,3759,3783,3774,16,7,1620,61146100,10270
1299,a1705,20160815,3783,3774,3771,3826,3744,3818,3804,44,30,4188,159350500,11080
1300,a1705,20160816,3818,3804,3825,3839,3814,3834,3828,30,24,2416,92498420,11276
1301,a1705,20160817,3834,3828,3839,3930,3812,3916,3872,88,44,6276,243011740,13190
1302,a1705,20160818,3916,3872,3922,3940,3901,3920,3922,48,50,4416,173227980,14714
1303,a1705,20160819,3920,3922,3915,3923,3841,3866,3879,-56,-43,7562,293353940,16040
1304,a1705,20160822,3866,3879,3862,3941,3848,3892,3915,13,36,8098,317070380,19274
1305,a1705,20160823,3892,3915,3858,3910,3839,3840,3878,-75,-37,4820,186933860,20676
1306,a1705,20160824,3840,3878,3840,3856,3801,3819,3823,-59,-55,10752,411124760,21606
1307,a1705,20160825,3819,3823,3815,3837,3781,3823,3812,0,-11,8162,311145060,22510
1308,a1705,20160826,3823,3812,3814,3825,3770,3787,3797,-25,-15,7142,271217480,22710
1309,a1705,20160829,3787,3797,3790,3821,3779,3810,3803,13,6,7200,273836260,24066
1310,a1705,20160830,3810,3803,3801,3834,3786,3806,3814,3,11,5708,217727640,24568
1311,a1705,20160831,3806,3814,3799,3811,3714,3722,3751,-92,-63,10932,410151000,25872
1312,a1705,20160901,3722,3751,3726,3731,3681,3690,3699,-61,-52,12146,449346480,28932
1313,a1705,20160902,3690,3699,3687,3720,3660,3667,3688,-32,-11,8766,323367760,30136
1314,a1705,20160905,3667,3688,3688,3689,3611,3629,3649,-59,-39,12508,456443040,30626
1315,a1705,20160906,3629,3649,3628,3645,3620,3636,3633,-13,-16,8326,302551820,30538
1316,a1705,20160907,3636,3633,3628,3669,3621,3664,3649,31,16,8782,320516180,31684
1317,a1705,20160908,3664,3649,3669,3680,3654,3662,3663,13,14,7212,264199700,32006
1318,a1705,20160909,3662,3663,3668,3674,3642,3666,3657,3,-6,6378,233284620,32260
1319,a1705,20160912,3666,3657,3665,3700,3638,3682,3675,25,18,7860,288856580,31556
1320,a1705,20160913,3682,3675,3679,3704,3664,3682,3685,7,10,7424,273587380,32064
1321,a1705,20160914,3682,3685,3664,3712,3620,3708,3677,23,-8,10772,396175260,32116
1322,a1705,20160919,3708,3677,3740,3833,3740,3823,3784,146,107,18162,687428040,31938
1323,a1705,20160920,3823,3784,3820,3841,3811,3831,3824,47,40,10244,391766780,32216
1324,a1705,20160921,3831,3824,3824,3845,3779,3790,3809,-34,-15,10108,385092880,31986
1325,a1705,20160922,3790,3809,3780,3818,3770,3794,3791,-15,-18,9316,353220520,32318
1326,a1705,20160923,3794,3791,3810,3818,3758,3778,3787,-13,-4,7968,301810320,32314
1327,a1705,20160926,3778,3787,3761,3796,3748,3774,3773,-13,-14,8704,328443800,33792
1328,a1705,20160927,3774,3773,3773,3780,3699,3708,3731,-65,-42,10886,406243760,34388
1329,a1705,20160928,3708,3731,3695,3736,3676,3681,3689,-50,-42,14906,549888740,34330
1330,a1705,20160929,3681,3689,3676,3718,3669,3694,3702,5,13,8588,317935240,34276
1331,a1705,20160930,3694,3702,3691,3760,3686,3760,3726,58,24,16070,598904120,37164
1332,a1705,20161010,3760,3726,3740,3793,3720,3764,3741,38,15,14452,540776500,40234
1333,a1705,20161011,3764,3741,3754,3769,3722,3736,3742,-5,1,21294,796988640,48910
1334,a1705,20161012,3736,3742,3736,3751,3659,3666,3699,-76,-43,21670,801649980,51762
1335,a1705,20161013,3666,3699,3671,3675,3633,3645,3654,-54,-45,19796,723383920,56020
1336,a1705,20161014,3645,3654,3651,3692,3647,3679,3673,25,19,21040,772858180,55502
1337,a1705,20161017,3679,3673,3682,3722,3668,3702,3700,29,27,25590,946911660,58140
1338,a1705,20161018,3702,3700,3709,3720,3679,3694,3696,-6,-4,23142,855368500,60100
1339,a1705,20161019,3694,3696,3689,3702,3662,3692,3685,-4,-11,19648,724117580,62706
1340,a1705,20161020,3692,3685,3688,3756,3687,3756,3722,71,37,35420,1318630160,58286
1341,a1705,20161021,3756,3722,3758,3792,3710,3778,3757,56,35,30196,1134667960,57334
1342,a1705,20161024,3778,3757,3779,3826,3758,3816,3795,59,38,34214,1298623840,64582
1343,a1705,20161025,3816,3795,3818,3859,3770,3783,3810,-12,15,38328,1460643960,65364
1344,a1705,20161026,3783,3810,3784,3905,3751,3898,3827,88,17,58774,2249706800,60654
1345,a1705,20161027,3898,3827,3896,3940,3871,3897,3904,70,77,56868,2220245300,55582
1346,a1705,20161028,3897,3904,3885,3915,3871,3890,3894,-14,-10,33244,1294608580,57480
1347,a1705,20161031,3890,3894,3888,3905,3851,3867,3872,-27,-22,25434,984942160,56796
1348,a1705,20161101,3867,3872,3850,3922,3848,3882,3894,10,22,41226,1605608540,64706
1349,a1705,20161102,3882,3894,3883,3909,3822,3834,3856,-60,-38,35124,1354603420,64814
1350,a1705,20161103,3834,3856,3845,3869,3802,3816,3837,-40,-19,25668,984903140,64432
1351,a1705,20161104,3816,3837,3824,3847,3801,3804,3827,-33,-10,21010,804258240,64394
1352,a1705,20161107,3804,3827,3809,3889,3790,3869,3845,42,18,30302,1165392620,68410
1353,a1705,20161108,3869,3845,3869,3908,3853,3893,3877,48,32,30392,1178544260,69398
1354,a1705,20161109,3893,3877,3894,3924,3837,3863,3885,-14,8,34228,1329913340,71216
1355,a1705,20161110,3863,3885,3868,3977,3852,3942,3913,57,28,65948,2580749040,75224
1356,a1705,20161111,3942,3913,3936,4061,3927,4014,4007,101,94,75050,3007486800,78252
1357,a1705,20161114,4014,4007,4007,4071,3807,3810,3893,-197,-114,83140,3237426700,68794
1358,a1705,20161115,3810,3893,3812,3884,3780,3788,3830,-105,-63,56334,2157983480,66224
1359,a1705,20161116,3788,3830,3792,3840,3788,3823,3817,-7,-13,35836,1368209280,71960
1360,a1705,20161117,3823,3817,3823,3840,3807,3823,3824,6,7,32580,1246181100,73676
1361,a1705,20161118,3823,3824,3824,3836,3788,3812,3811,-12,-13,27116,1033529400,76880
1362,a1705,20161121,3812,3811,3823,3870,3800,3851,3839,40,28,39948,1533640400,78980
1363,a1705,20161122,3851,3839,3852,3914,3851,3901,3884,62,45,50916,1977943840,82592
1364,a1705,20161123,3901,3884,3888,3960,3870,3922,3920,38,36,49044,1922849540,78904
1365,a1705,20161124,3922,3920,3906,4005,3902,3920,3954,0,34,88508,3500264280,89526
1366,a1705,20161125,3920,3954,3915,3952,3892,3945,3930,-9,-24,49566,1948028780,92170
1367,a1705,20161128,3945,3930,3956,4048,3932,4020,3997,90,67,97174,3884062840,99106
1368,a1705,20161129,4020,3997,4019,4138,4003,4089,4089,92,92,223632,9145421540,135972
1369,a1705,20161130,4089,4089,4068,4100,3967,3997,4039,-92,-50,213344,8618744100,137362
1370,a1705,20161201,3997,4039,4013,4092,4011,4059,4051,20,12,175930,7126974720,158666
1371,a1705,20161202,4059,4051,4058,4235,4026,4192,4151,141,100,528772,21953145400,216290
1372,a1705,20161205,4192,4151,4198,4258,4171,4211,4213,60,62,368790,15540267700,214286
1373,a1705,20161206,4211,4213,4220,4233,4160,4184,4193,-29,-20,213396,8949663460,215690
1374,a1705,20161207,4184,4193,4223,4294,4176,4251,4237,58,44,327114,13860836680,248900
1375,a1705,20161208,4251,4237,4243,4263,4166,4190,4207,-47,-30,220032,9258875940,222682
1376,a1705,20161209,4190,4207,4190,4199,4131,4183,4164,-24,-43,181808,7570999620,217636
1377,a1705,20161212,4183,4164,4185,4234,4166,4198,4206,34,42,197078,8289735240,218196
1378,a1705,20161213,4198,4206,4186,4227,4163,4217,4204,11,-2,149034,6265683660,216242
1379,a1705,20161214,4217,4204,4218,4236,4172,4192,4202,-12,-2,162526,6830884440,215258
1380,a1705,20161215,4192,4202,4190,4236,4165,4211,4203,9,1,173078,7274979240,221034
1381,a1705,20161216,4211,4203,4200,4386,4193,4349,4314,146,111,442174,19075533120,279872
1382,a1705,20161219,4349,4314,4360,4412,4318,4347,4370,33,56,362842,15859466920,278804
1383,a1705,20161220,4347,4370,4350,4358,4245,4270,4304,-100,-66,295466,12718861740,243728
1384,a1705,20161221,4270,4304,4271,4407,4252,4371,4352,67,48,471894,20536878200,294702
1385,a1705,20161222,4371,4352,4375,4416,4339,4341,4378,-11,26,422184,18484205700,308708
1386,a1705,20161223,4341,4378,4330,4363,4281,4342,4318,-36,-60,404254,17458169340,292032
1387,a1705,20161226,4342,4318,4346,4361,4103,4143,4225,-175,-93,479348,20254009860,230758
1388,a1705,20161227,4143,4225,4140,4209,4126,4183,4163,-42,-62,281654,11727000180,214582
1389,a1705,20161228,4183,4163,4196,4275,4177,4191,4220,28,57,299454,12638538640,208278
1390,a1705,20161229,4191,4220,4203,4377,4161,4322,4291,102,71,608312,26104279640,245862
1391,a1705,20161230,4322,4291,4329,4341,4259,4279,4296,-12,5,312620,13430915960,233544
1392,a1707,20160118,3436,3436,0,0,0,3442,3442,6,6,0,0,0
1393,a1707,20160119,3442,3442,0,0,0,3442,3442,0,0,0,0,0
1394,a1707,20160120,3442,3442,0,0,0,3442,3442,0,0,0,0,0
1395,a1707,20160121,3442,3442,0,0,0,3442,3442,0,0,0,0,0
1396,a1707,20160122,3442,3442,0,0,0,3442,3442,0,0,0,0,0
1397,a1707,20160125,3442,3442,0,0,0,3457,3457,15,15,0,0,0
1398,a1707,20160126,3457,3457,0,0,0,3457,3457,0,0,0,0,0
1399,a1707,20160127,3457,3457,0,0,0,3457,3457,0,0,0,0,0
1400,a1707,20160128,3457,3457,0,0,0,3457,3457,0,0,0,0,0
1401,a1707,20160129,3457,3457,0,0,0,3457,3457,0,0,0,0,0
1402,a1707,20160201,3457,3457,0,0,0,3457,3457,0,0,0,0,0
1403,a1707,20160202,3457,3457,0,0,0,3457,3457,0,0,0,0,0
1404,a1707,20160203,3457,3457,0,0,0,3452,3452,-5,-5,0,0,0
1405,a1707,20160204,3452,3452,0,0,0,3434,3434,-18,-18,0,0,0
1406,a1707,20160205,3434,3434,0,0,0,3430,3430,-4,-4,0,0,0
1407,a1707,20160215,3430,3430,0,0,0,3430,3430,0,0,0,0,0
1408,a1707,20160216,3430,3430,0,0,0,3430,3430,0,0,0,0,0
1409,a1707,20160217,3430,3430,0,0,0,3433,3433,3,3,0,0,0
1410,a1707,20160218,3433,3433,0,0,0,3433,3433,0,0,0,0,0
1411,a1707,20160219,3433,3433,0,0,0,3437,3437,4,4,0,0,0
1412,a1707,20160222,3437,3437,0,0,0,3455,3455,18,18,0,0,0
1413,a1707,20160223,3455,3455,0,0,0,3455,3455,0,0,0,0,0
1414,a1707,20160224,3455,3455,0,0,0,3455,3455,0,0,0,0,0
1415,a1707,20160225,3455,3455,0,0,0,3450,3450,-5,-5,0,0,0
1416,a1707,20160226,3450,3450,0,0,0,3444,3444,-6,-6,0,0,0
1417,a1707,20160229,3444,3444,0,0,0,3406,3406,-38,-38,0,0,0
1418,a1707,20160301,3406,3406,0,0,0,3418,3418,12,12,0,0,0
1419,a1707,20160302,3418,3418,0,0,0,3418,3418,0,0,0,0,0
1420,a1707,20160303,3418,3418,0,0,0,3448,3448,30,30,0,0,0
1421,a1707,20160304,3448,3448,0,0,0,3469,3469,21,21,0,0,0
1422,a1707,20160307,3469,3469,0,0,0,3492,3492,23,23,0,0,0
1423,a1707,20160308,3492,3492,0,0,0,3488,3488,-4,-4,0,0,0
1424,a1707,20160309,3488,3488,0,0,0,3471,3471,-17,-17,0,0,0
1425,a1707,20160310,3471,3471,0,0,0,3469,3469,-2,-2,0,0,0
1426,a1707,20160311,3469,3469,0,0,0,3456,3456,-13,-13,0,0,0
1427,a1707,20160314,3456,3456,0,0,0,3456,3456,0,0,0,0,0
1428,a1707,20160315,3456,3456,0,0,0,3456,3456,0,0,0,0,0
1429,a1707,20160316,3456,3456,0,0,0,3420,3420,-36,-36,0,0,0
1430,a1707,20160317,3420,3420,0,0,0,3428,3428,8,8,0,0,0
1431,a1707,20160318,3428,3428,0,0,0,3480,3480,52,52,0,0,0
1432,a1707,20160321,3480,3480,0,0,0,3488,3488,8,8,0,0,0
1433,a1707,20160322,3488,3488,0,0,0,3488,3488,0,0,0,0,0
1434,a1707,20160323,3488,3488,0,0,0,3517,3517,29,29,0,0,0
1435,a1707,20160324,3517,3517,0,0,0,3517,3517,0,0,0,0,0
1436,a1707,20160325,3517,3517,3655,3655,3655,3655,3655,138,138,2,73100,2
1437,a1707,20160328,3655,3655,0,0,0,3669,3669,14,14,0,0,2
1438,a1707,20160329,3669,3669,0,0,0,3621,3621,-48,-48,0,0,2
1439,a1707,20160330,3621,3621,3601,3608,3601,3601,3602,-20,-19,8,288220,10
1440,a1707,20160331,3601,3602,3603,3603,3603,3603,3603,1,1,6,216180,16
1441,a1707,20160401,3603,3603,3475,3475,3472,3472,3473,-131,-130,4,138940,12
1442,a1707,20160405,3472,3473,0,0,0,3439,3439,-34,-34,0,0,12
1443,a1707,20160406,3439,3439,0,0,0,3411,3411,-28,-28,0,0,12
1444,a1707,20160407,3411,3411,0,0,0,3415,3415,4,4,0,0,12
1445,a1707,20160408,3415,3415,0,0,0,3413,3413,-2,-2,0,0,12
1446,a1707,20160411,3413,3413,0,0,0,3413,3413,0,0,0,0,12
1447,a1707,20160412,3413,3413,0,0,0,3426,3426,13,13,0,0,12
1448,a1707,20160413,3426,3426,3487,3509,3461,3500,3488,74,62,22,767360,6
1449,a1707,20160414,3500,3488,0,0,0,3508,3508,20,20,0,0,6
1450,a1707,20160415,3508,3508,0,0,0,3502,3502,-6,-6,0,0,6
1451,a1707,20160418,3502,3502,0,0,0,3520,3520,18,18,0,0,6
1452,a1707,20160419,3520,3520,0,0,0,3520,3520,0,0,0,0,6
1453,a1707,20160420,3520,3520,0,0,0,3622,3622,102,102,0,0,6
1454,a1707,20160421,3622,3622,0,0,0,3766,3766,144,144,0,0,6
1455,a1707,20160422,3766,3766,3850,3878,3695,3792,3780,26,14,32,1209760,32
1456,a1707,20160425,3792,3780,3723,3747,3723,3747,3735,-33,-45,4,149400,30
1457,a1707,20160426,3747,3735,3849,3849,3788,3788,3818,53,83,4,152740,30
1458,a1707,20160427,3788,3818,0,0,0,3818,3818,0,0,0,0,30
1459,a1707,20160428,3818,3818,3720,3720,3720,3720,3720,-98,-98,2,74400,30
1460,a1707,20160429,3720,3720,0,0,0,3720,3720,0,0,0,0,30
1461,a1707,20160503,3720,3720,0,0,0,3736,3736,16,16,0,0,30
1462,a1707,20160504,3736,3736,3740,3740,3740,3740,3740,4,4,20,748000,12
1463,a1707,20160505,3740,3740,3730,3730,3730,3730,3730,-10,-10,2,74600,10
1464,a1707,20160506,3730,3730,0,0,0,3730,3730,0,0,0,0,10
1465,a1707,20160509,3730,3730,3663,3663,3663,3663,3663,-67,-67,4,146520,10
1466,a1707,20160510,3663,3663,0,0,0,3663,3663,0,0,0,0,10
1467,a1707,20160511,3663,3663,0,0,0,3780,3780,117,117,0,0,10
1468,a1707,20160512,3780,3780,0,0,0,3780,3780,0,0,0,0,10
1469,a1707,20160513,3780,3780,0,0,0,3716,3716,-64,-64,0,0,10
1470,a1707,20160516,3716,3716,0,0,0,3716,3716,0,0,0,0,10
1471,a1707,20160517,3716,3716,0,0,0,3806,3806,90,90,0,0,10
1472,a1707,20160518,3806,3806,3839,3839,3839,3839,3839,33,33,4,153560,8
1473,a1707,20160519,3839,3839,0,0,0,3817,3817,-22,-22,0,0,8
1474,a1707,20160520,3817,3817,3779,3779,3779,3779,3779,-38,-38,2,75580,6
1475,a1707,20160523,3779,3779,0,0,0,3764,3764,-15,-15,0,0,6
1476,a1707,20160524,3764,3764,0,0,0,3684,3684,-80,-80,0,0,6
1477,a1707,20160525,3684,3684,0,0,0,3654,3654,-30,-30,0,0,6
1478,a1707,20160526,3654,3654,0,0,0,3711,3711,57,57,0,0,6
1479,a1707,20160527,3711,3711,0,0,0,3726,3726,15,15,0,0,6
1480,a1707,20160530,3726,3726,0,0,0,3770,3770,44,44,0,0,6
1481,a1707,20160531,3770,3770,0,0,0,3770,3770,0,0,0,0,6
1482,a1707,20160601,3770,3770,0,0,0,3770,3770,0,0,0,0,6
1483,a1707,20160602,3770,3770,0,0,0,3796,3796,26,26,0,0,6
1484,a1707,20160603,3796,3796,0,0,0,3796,3796,0,0,0,0,6
1485,a1707,20160606,3796,3796,0,0,0,3796,3796,0,0,0,0,6
1486,a1707,20160607,3796,3796,3812,3812,3812,3812,3812,16,16,4,152480,2
1487,a1707,20160608,3812,3812,0,0,0,3812,3812,0,0,0,0,2
1488,a1707,20160613,3812,3812,0,0,0,3938,3938,126,126,0,0,2
1489,a1707,20160614,3938,3938,0,0,0,3938,3938,0,0,0,0,2
1490,a1707,20160615,3938,3938,0,0,0,3938,3938,0,0,0,0,2
1491,a1707,20160616,3938,3938,0,0,0,3918,3918,-20,-20,0,0,2
1492,a1707,20160617,3918,3918,0,0,0,3918,3918,0,0,0,0,2
1493,a1707,20160620,3918,3918,3860,3860,3841,3841,3850,-77,-68,4,154020,2
1494,a1707,20160621,3841,3850,0,0,0,3850,3850,0,0,0,0,2
1495,a1707,20160622,3850,3850,0,0,0,3850,3850,0,0,0,0,2
1496,a1707,20160623,3850,3850,0,0,0,3850,3850,0,0,0,0,2
1497,a1707,20160624,3850,3850,0,0,0,3850,3850,0,0,0,0,2
1498,a1707,20160627,3850,3850,0,0,0,3873,3873,23,23,0,0,2
1499,a1707,20160628,3873,3873,0,0,0,3873,3873,0,0,0,0,2
1500,a1707,20160629,3873,3873,0,0,0,3892,3892,19,19,0,0,2
1501,a1707,20160630,3892,3892,0,0,0,3939,3939,47,47,0,0,2
1502,a1707,20160701,3939,3939,3987,3987,3987,3987,3987,48,48,2,79740,4
1503,a1707,20160704,3987,3987,0,0,0,3987,3987,0,0,0,0,4
1504,a1707,20160705,3987,3987,0,0,0,3987,3987,0,0,0,0,4
1505,a1707,20160706,3987,3987,0,0,0,3928,3928,-59,-59,0,0,4
1506,a1707,20160707,3928,3928,0,0,0,3894,3894,-34,-34,0,0,4
1507,a1707,20160708,3894,3894,0,0,0,3894,3894,0,0,0,0,4
1508,a1707,20160711,3894,3894,0,0,0,3894,3894,0,0,0,0,4
1509,a1707,20160712,3894,3894,0,0,0,3894,3894,0,0,0,0,4
1510,a1707,20160713,3894,3894,3891,3911,3873,3891,3889,-3,-5,12,466700,6
1511,a1707,20160714,3891,3889,0,0,0,3941,3941,52,52,0,0,6
1512,a1707,20160715,3941,3941,3935,3935,3935,3935,3935,-6,-6,2,78700,6
1513,a1707,20160718,3935,3935,3885,3885,3885,3885,3885,-50,-50,2,77700,4
1514,a1707,20160719,3885,3885,0,0,0,3885,3885,0,0,0,0,4
1515,a1707,20160720,3885,3885,0,0,0,3885,3885,0,0,0,0,4
1516,a1707,20160721,3885,3885,0,0,0,3876,3876,-9,-9,0,0,4
1517,a1707,20160722,3876,3876,3837,3837,3799,3799,3819,-77,-57,18,687420,4
1518,a1707,20160725,3799,3819,3705,3742,3705,3739,3725,-80,-94,18,670540,6
1519,a1707,20160726,3739,3725,0,0,0,3725,3725,0,0,0,0,6
1520,a1707,20160727,3725,3725,0,0,0,3725,3725,0,0,0,0,6
1521,a1707,20160728,3725,3725,3878,3878,3878,3878,3878,153,153,2,77560,8
1522,a1707,20160729,3878,3878,0,0,0,3844,3844,-34,-34,0,0,8
1523,a1707,20160801,3844,3844,0,0,0,3871,3871,27,27,0,0,8
1524,a1707,20160802,3871,3871,3730,3730,3717,3717,3721,-154,-150,6,223300,12
1525,a1707,20160803,3717,3721,3732,3732,3681,3681,3714,-40,-7,6,222860,12
1526,a1707,20160804,3681,3714,0,0,0,3714,3714,0,0,0,0,12
1527,a1707,20160805,3714,3714,0,0,0,3714,3714,0,0,0,0,12
1528,a1707,20160808,3714,3714,3760,3760,3760,3760,3760,46,46,2,75200,12
1529,a1707,20160809,3760,3760,0,0,0,3760,3760,0,0,0,0,12
1530,a1707,20160810,3760,3760,0,0,0,3760,3760,0,0,0,0,12
1531,a1707,20160811,3760,3760,0,0,0,3760,3760,0,0,0,0,12
1532,a1707,20160812,3760,3760,0,0,0,3760,3760,0,0,0,0,12
1533,a1707,20160815,3760,3760,0,0,0,3789,3789,29,29,0,0,12
1534,a1707,20160816,3789,3789,0,0,0,3789,3789,0,0,0,0,12
1535,a1707,20160817,3789,3789,0,0,0,3789,3789,0,0,0,0,12
1536,a1707,20160818,3789,3789,0,0,0,3837,3837,48,48,0,0,12
1537,a1707,20160819,3837,3837,0,0,0,3837,3837,0,0,0,0,12
1538,a1707,20160822,3837,3837,0,0,0,3837,3837,0,0,0,0,12
1539,a1707,20160823,3837,3837,0,0,0,3837,3837,0,0,0,0,12
1540,a1707,20160824,3837,3837,0,0,0,3837,3837,0,0,0,0,12
1541,a1707,20160825,3837,3837,0,0,0,3837,3837,0,0,0,0,12
1542,a1707,20160826,3837,3837,0,0,0,3837,3837,0,0,0,0,12
1543,a1707,20160829,3837,3837,0,0,0,3837,3837,0,0,0,0,12
1544,a1707,20160830,3837,3837,0,0,0,3837,3837,0,0,0,0,12
1545,a1707,20160831,3837,3837,0,0,0,3837,3837,0,0,0,0,12
1546,a1707,20160901,3837,3837,3785,3785,3726,3726,3751,-111,-86,6,225060,12
1547,a1707,20160902,3726,3751,0,0,0,3750,3750,-1,-1,0,0,12
1548,a1707,20160905,3750,3750,3697,3729,3697,3729,3712,-21,-38,12,445440,14
1549,a1707,20160906,3729,3712,0,0,0,3712,3712,0,0,0,0,14
1550,a1707,20160907,3712,3712,3706,3706,3706,3706,3706,-6,-6,2,74120,14
1551,a1707,20160908,3706,3706,0,0,0,3706,3706,0,0,0,0,14
1552,a1707,20160909,3706,3706,0,0,0,3706,3706,0,0,0,0,14
1553,a1707,20160912,3706,3706,0,0,0,3706,3706,0,0,0,0,14
1554,a1707,20160913,3706,3706,0,0,0,3706,3706,0,0,0,0,14
1555,a1707,20160914,3706,3706,3710,3710,3710,3710,3710,4,4,2,74200,12
1556,a1707,20160919,3710,3710,3790,3790,3790,3790,3790,80,80,2,75800,12
1557,a1707,20160920,3790,3790,0,0,0,3820,3820,30,30,0,0,12
1558,a1707,20160921,3820,3820,0,0,0,3820,3820,0,0,0,0,12
1559,a1707,20160922,3820,3820,0,0,0,3820,3820,0,0,0,0,12
1560,a1707,20160923,3820,3820,0,0,0,3820,3820,0,0,0,0,12
1561,a1707,20160926,3820,3820,0,0,0,3820,3820,0,0,0,0,12
1562,a1707,20160927,3820,3820,0,0,0,3820,3820,0,0,0,0,12
1563,a1707,20160928,3820,3820,0,0,0,3820,3820,0,0,0,0,12
1564,a1707,20160929,3820,3820,0,0,0,3820,3820,0,0,0,0,12
1565,a1707,20160930,3820,3820,3823,3829,3800,3803,3820,-17,0,28,1069660,32
1566,a1707,20161010,3803,3820,3739,3762,3734,3762,3744,-58,-76,30,1123480,14
1567,a1707,20161011,3762,3744,0,0,0,3744,3744,0,0,0,0,14
1568,a1707,20161012,3744,3744,3710,3710,3710,3710,3710,-34,-34,4,148400,14
1569,a1707,20161013,3710,3710,0,0,0,3682,3682,-28,-28,0,0,14
1570,a1707,20161014,3682,3682,0,0,0,3690,3690,8,8,0,0,14
1571,a1707,20161017,3690,3690,0,0,0,3720,3720,30,30,0,0,14
1572,a1707,20161018,3720,3720,0,0,0,3720,3720,0,0,0,0,14
1573,a1707,20161019,3720,3720,3746,3746,3701,3708,3720,-12,0,8,297620,14
1574,a1707,20161020,3708,3720,0,0,0,3730,3730,10,10,0,0,14
1575,a1707,20161021,3730,3730,0,0,0,3765,3765,35,35,0,0,14
1576,a1707,20161024,3765,3765,0,0,0,3790,3790,25,25,0,0,14
1577,a1707,20161025,3790,3790,0,0,0,3790,3790,0,0,0,0,14
1578,a1707,20161026,3790,3790,3789,3892,3789,3892,3833,102,43,190,7283980,36
1579,a1707,20161027,3892,3833,0,0,0,3872,3872,39,39,0,0,36
1580,a1707,20161028,3872,3872,0,0,0,3873,3873,1,1,0,0,36
1581,a1707,20161031,3873,3873,0,0,0,3873,3873,0,0,0,0,36
1582,a1707,20161101,3873,3873,0,0,0,3873,3873,0,0,0,0,36
1583,a1707,20161102,3873,3873,0,0,0,3873,3873,0,0,0,0,36
1584,a1707,20161103,3873,3873,3875,3875,3875,3875,3875,2,2,2,77500,36
1585,a1707,20161104,3875,3875,0,0,0,3875,3875,0,0,0,0,36
1586,a1707,20161107,3875,3875,0,0,0,3875,3875,0,0,0,0,36
1587,a1707,20161108,3875,3875,0,0,0,3880,3880,5,5,0,0,36
1588,a1707,20161109,3880,3880,0,0,0,3880,3880,0,0,0,0,36
1589,a1707,20161110,3880,3880,3954,3954,3952,3954,3953,74,73,8,316280,32
1590,a1707,20161111,3954,3953,3954,4138,3954,4138,4042,185,89,12,485100,32
1591,a1707,20161114,4138,4042,3840,3899,3840,3899,3869,-143,-173,4,154780,32
1592,a1707,20161115,3899,3869,0,0,0,3869,3869,0,0,0,0,32
1593,a1707,20161116,3869,3869,0,0,0,3869,3869,0,0,0,0,32
1594,a1707,20161117,3869,3869,0,0,0,3869,3869,0,0,0,0,32
1595,a1707,20161118,3869,3869,0,0,0,3869,3869,0,0,0,0,32
1596,a1707,20161121,3869,3869,0,0,0,3869,3869,0,0,0,0,32
1597,a1707,20161122,3869,3869,0,0,0,3869,3869,0,0,0,0,32
1598,a1707,20161123,3869,3869,0,0,0,3869,3869,0,0,0,0,32
1599,a1707,20161124,3869,3869,3919,3919,3919,3919,3919,50,50,2,78380,30
1600,a1707,20161125,3919,3919,0,0,0,3919,3919,0,0,0,0,30
1601,a1707,20161128,3919,3919,0,0,0,3960,3960,41,41,0,0,30
1602,a1707,20161129,3960,3960,4138,4138,4078,4095,4106,135,146,14,574860,32
1603,a1707,20161130,4095,4106,4044,4044,3903,3988,4009,-118,-97,12,481100,30
1604,a1707,20161201,3988,4009,4009,4009,4009,4009,4009,0,0,22,881980,8
1605,a1707,20161202,4009,4009,4049,4208,4003,4208,4135,199,126,10,413520,12
1606,a1707,20161205,4208,4135,0,0,0,4135,4135,0,0,0,0,12
1607,a1707,20161206,4135,4135,4234,4234,4143,4165,4178,30,43,110,4596000,32
1608,a1707,20161207,4165,4178,4205,4205,4205,4205,4205,27,27,2,84100,32
1609,a1707,20161208,4205,4205,4244,4245,4209,4209,4227,4,22,22,930040,32
1610,a1707,20161209,4209,4227,4067,4150,4067,4150,4108,-77,-119,4,164340,34
1611,a1707,20161212,4150,4108,4168,4282,4168,4220,4203,112,95,50,2101940,30
1612,a1707,20161213,4220,4203,0,0,0,4203,4203,0,0,0,0,30
1613,a1707,20161214,4203,4203,0,0,0,4203,4203,0,0,0,0,30
1614,a1707,20161215,4203,4203,0,0,0,4203,4203,0,0,0,0,30
1615,a1707,20161216,4203,4203,4250,4352,4250,4352,4261,149,58,22,937600,30
1616,a1707,20161219,4352,4261,4296,4321,4296,4320,4317,59,56,16,690740,28
1617,a1707,20161220,4320,4317,4266,4266,4266,4266,4266,-51,-51,2,85320,26
1618,a1707,20161221,4266,4266,0,0,0,4266,4266,0,0,0,0,26
1619,a1707,20161222,4266,4266,0,0,0,4266,4266,0,0,0,0,26
1620,a1707,20161223,4266,4266,4350,4350,4224,4299,4297,33,31,20,859500,28
1621,a1707,20161226,4299,4297,0,0,0,4205,4205,-92,-92,0,0,28
1622,a1707,20161227,4205,4205,0,0,0,4205,4205,0,0,0,0,28
1623,a1707,20161228,4205,4205,0,0,0,4205,4205,0,0,0,0,28
1624,a1707,20161229,4205,4205,0,0,0,4205,4205,0,0,0,0,28
1625,a1707,20161230,4205,4205,4265,4265,4265,4265,4265,60,60,2,85300,30
1626,a1709,20160315,3461,3461,3605,3605,3451,3460,3501,-1,40,40,1400620,20
1627,a1709,20160316,3460,3501,3425,3481,3425,3439,3446,-62,-55,52,1792000,48
1628,a1709,20160317,3439,3446,3443,3461,3439,3459,3446,13,0,24,827080,52
1629,a1709,20160318,3459,3446,3479,3559,3478,3511,3495,65,49,50,1747580,52
1630,a1709,20160321,3511,3495,3509,3529,3501,3510,3511,15,16,24,842660,60
1631,a1709,20160322,3510,3511,3532,3577,3512,3550,3541,39,30,38,1345820,68
1632,a1709,20160323,3550,3541,3600,3609,3593,3600,3600,59,59,20,720100,64
1633,a1709,20160324,3600,3600,3595,3619,3559,3610,3593,10,-7,46,1652920,68
1634,a1709,20160325,3610,3593,3626,3659,3623,3655,3642,62,49,54,1966680,66
1635,a1709,20160328,3655,3642,3660,3726,3648,3659,3677,17,35,80,2942320,86
1636,a1709,20160329,3659,3677,3622,3642,3621,3640,3633,-37,-44,24,871920,92
1637,a1709,20160330,3640,3633,3622,3639,3591,3593,3614,-40,-19,154,5566580,176
1638,a1709,20160331,3593,3614,3592,3627,3556,3561,3579,-53,-35,104,3722220,222
1639,a1709,20160401,3561,3579,3573,3573,3487,3487,3503,-92,-76,216,7566740,310
1640,a1709,20160405,3487,3503,3490,3499,3482,3490,3487,-13,-16,106,3697200,292
1641,a1709,20160406,3490,3487,3484,3491,3451,3458,3460,-29,-27,76,2630300,326
1642,a1709,20160407,3458,3460,3489,3490,3455,3477,3478,17,18,42,1460860,330
1643,a1709,20160408,3477,3478,3481,3492,3477,3480,3482,2,4,22,766200,330
1644,a1709,20160411,3480,3482,3470,3503,3468,3496,3484,14,2,192,6689480,328
1645,a1709,20160412,3496,3484,3499,3525,3492,3509,3511,25,27,138,4846440,338
1646,a1709,20160413,3509,3511,3545,3545,3502,3514,3521,3,10,346,12184220,456
1647,a1709,20160414,3514,3521,3514,3559,3514,3540,3540,19,19,194,6868380,394
1648,a1709,20160415,3540,3540,3551,3552,3520,3525,3531,-15,-9,108,3813640,428
1649,a1709,20160418,3525,3531,3505,3581,3505,3581,3550,50,19,138,4899580,436
1650,a1709,20160419,3581,3550,3552,3601,3552,3590,3582,40,32,180,6448740,396
1651,a1709,20160420,3590,3582,3616,3725,3616,3725,3700,143,118,420,15540080,544
1652,a1709,20160421,3725,3700,3824,3848,3700,3848,3802,148,102,308,11711380,568
1653,a1709,20160422,3848,3802,3920,3928,3680,3755,3824,-47,22,510,19505520,540
1654,a1709,20160425,3755,3824,3731,3877,3731,3785,3806,-39,-18,472,17967680,480
1655,a1709,20160426,3785,3806,3781,3988,3765,3790,3861,-16,55,3968,153234980,706
1656,a1709,20160427,3790,3861,3819,3826,3777,3789,3800,-72,-61,176,6689740,754
1657,a1709,20160428,3789,3800,3786,3786,3700,3730,3744,-70,-56,256,9585420,852
1658,a1709,20160429,3730,3744,3739,3766,3715,3715,3740,-29,-4,140,5237380,886
1659,a1709,20160503,3715,3740,3738,3814,3738,3814,3786,74,46,132,4997740,882
1660,a1709,20160504,3814,3786,3825,3830,3746,3753,3776,-33,-10,160,6041900,948
1661,a1709,20160505,3753,3776,3765,3787,3717,3717,3753,-59,-23,138,5179300,932
1662,a1709,20160506,3717,3753,3750,3750,3629,3638,3663,-115,-90,300,10991300,970
1663,a1709,20160509,3638,3663,3646,3707,3630,3657,3664,-6,1,196,7182240,978
1664,a1709,20160510,3657,3664,3649,3682,3610,3665,3635,1,-29,356,12943860,1016
1665,a1709,20160511,3665,3635,3679,3816,3665,3816,3749,181,114,654,24521320,892
1666,a1709,20160512,3816,3749,3809,3837,3766,3788,3801,39,52,604,22963760,792
1667,a1709,20160513,3788,3801,3753,3805,3686,3707,3730,-94,-71,346,12905840,758
1668,a1709,20160516,3707,3730,3685,3759,3661,3742,3734,12,4,150,5601060,762
1669,a1709,20160517,3742,3734,3769,3781,3741,3781,3764,47,30,216,8131880,756
1670,a1709,20160518,3781,3764,3776,3875,3770,3782,3819,18,55,442,16881520,776
1671,a1709,20160519,3782,3819,3778,3809,3750,3809,3785,-10,-34,248,9388080,780
1672,a1709,20160520,3809,3785,3771,3801,3771,3789,3786,4,1,158,5983040,776
1673,a1709,20160523,3789,3786,3833,3833,3720,3748,3773,-38,-13,194,7320160,756
1674,a1709,20160524,3748,3773,3700,3735,3626,3644,3670,-129,-103,208,7635240,760
1675,a1709,20160525,3644,3670,3640,3683,3638,3671,3661,1,-9,44,1610960,764
1676,a1709,20160526,3671,3661,3754,3755,3688,3755,3724,94,63,70,2607040,752
1677,a1709,20160527,3755,3724,3756,3772,3710,3742,3734,18,10,78,2912860,724
1678,a1709,20160530,3742,3734,3743,3833,3743,3817,3797,83,63,126,4784940,710
1679,a1709,20160531,3817,3797,3797,3843,3750,3809,3789,12,-8,322,12201680,770
1680,a1709,20160601,3809,3789,3820,3858,3760,3771,3812,-18,23,274,10445240,708
1681,a1709,20160602,3771,3812,3786,3863,3786,3821,3825,9,13,72,2754100,682
1682,a1709,20160603,3821,3825,3839,3851,3802,3806,3826,-19,1,114,4361720,682
1683,a1709,20160606,3806,3826,3825,3843,3805,3819,3822,-7,-4,180,6880920,670
1684,a1709,20160607,3819,3822,3850,3850,3813,3843,3832,21,10,104,3986220,660
1685,a1709,20160608,3843,3832,3836,3843,3810,3838,3830,6,-2,66,2527980,640
1686,a1709,20160613,3838,3830,3985,4012,3901,3970,3950,140,120,126,4977660,598
1687,a1709,20160614,3970,3950,3967,3967,3874,3902,3905,-48,-45,130,5077020,624
1688,a1709,20160615,3902,3905,3901,3958,3857,3886,3881,-19,-24,258,10014300,676
1689,a1709,20160616,3886,3881,3889,3918,3830,3830,3877,-51,-4,126,4886000,684
1690,a1709,20160617,3830,3877,3837,3879,3808,3853,3836,-24,-41,68,2608880,682
1691,a1709,20160620,3853,3836,3896,3909,3848,3858,3867,22,31,82,3171260,678
1692,a1709,20160621,3858,3867,3876,3909,3873,3886,3886,19,19,44,1710020,672
1693,a1709,20160622,3886,3886,3844,3886,3844,3886,3860,0,-26,66,2547860,698
1694,a1709,20160623,3886,3860,3881,3914,3862,3862,3895,2,35,196,7634220,682
1695,a1709,20160624,3862,3895,3853,3894,3836,3836,3881,-59,-14,206,7996680,670
1696,a1709,20160627,3836,3881,3803,3899,3800,3896,3872,15,-9,104,4027580,668
1697,a1709,20160628,3896,3872,3909,3936,3883,3924,3913,52,41,448,17534460,824
1698,a1709,20160629,3924,3913,3945,3947,3894,3910,3920,-3,7,176,6900540,842
1699,a1709,20160630,3910,3920,3908,3979,3908,3973,3937,53,17,106,4173720,838
1700,a1709,20160701,3973,3937,3957,4048,3928,3964,3984,27,47,124,4941360,832
1701,a1709,20160704,3964,3984,4007,4037,3975,3990,4004,6,20,126,5045180,794
1702,a1709,20160705,3990,4004,4007,4007,3950,3988,3976,-16,-28,156,6203960,850
1703,a1709,20160706,3988,3976,3995,4008,3880,3926,3933,-50,-43,210,8259800,896
1704,a1709,20160707,3926,3933,3900,3930,3853,3895,3877,-38,-56,374,14503420,908
1705,a1709,20160708,3895,3877,3899,3934,3845,3880,3865,3,-12,278,10746860,924
1706,a1709,20160711,3880,3865,3886,3930,3863,3886,3897,21,32,130,5066760,906
1707,a1709,20160712,3886,3897,3903,3912,3882,3900,3896,3,-1,44,1714480,902
1708,a1709,20160713,3900,3896,3918,3950,3911,3932,3935,36,39,230,9051600,738
1709,a1709,20160714,3932,3935,3967,3992,3942,3975,3960,40,25,194,7682580,720
1710,a1709,20160715,3975,3960,3965,3965,3918,3933,3930,-27,-30,122,4795780,702
1711,a1709,20160718,3933,3930,3931,3973,3900,3903,3926,-27,-4,60,2355960,702
1712,a1709,20160719,3903,3926,3895,3934,3895,3923,3913,-3,-13,80,3131160,688
1713,a1709,20160720,3923,3913,3908,3913,3861,3886,3892,-27,-21,318,12379120,740
1714,a1709,20160721,3886,3892,3884,3899,3843,3855,3866,-37,-26,80,3093020,736
1715,a1709,20160722,3855,3866,3867,3869,3798,3800,3824,-66,-42,188,7189740,762
1716,a1709,20160725,3800,3824,3791,3793,3740,3778,3762,-46,-62,542,20394520,814
1717,a1709,20160726,3778,3762,3765,3769,3750,3765,3757,3,-5,72,2705220,806
1718,a1709,20160727,3765,3757,3765,3785,3751,3783,3776,26,19,88,3323080,794
1719,a1709,20160728,3783,3776,3786,3789,3760,3760,3772,-16,-4,22,829900,792
1720,a1709,20160729,3760,3772,3760,3766,3718,3721,3738,-51,-34,138,5159700,834
1721,a1709,20160801,3721,3738,3731,3792,3731,3792,3757,54,19,72,2705740,784
1722,a1709,20160802,3792,3757,3721,3721,3717,3717,3720,-40,-37,18,669660,796
1723,a1709,20160803,3717,3720,3741,3756,3721,3756,3745,36,25,24,898880,788
1724,a1709,20160804,3756,3745,3752,3770,3736,3770,3750,25,5,22,825080,784
1725,a1709,20160805,3770,3750,3775,3829,3747,3806,3806,56,56,120,4567380,766
1726,a1709,20160808,3806,3806,3825,3834,3811,3822,3825,16,19,28,1071160,750
1727,a1709,20160809,3822,3825,3810,3819,3800,3813,3808,-12,-17,18,685520,746
1728,a1709,20160810,3813,3808,3824,3849,3824,3849,3841,41,33,54,2074200,716
1729,a1709,20160811,3849,3841,3836,3846,3828,3828,3834,-13,-7,36,1380440,714
1730,a1709,20160812,3828,3834,3835,3835,3814,3830,3830,-4,-4,44,1685280,740
1731,a1709,20160815,3830,3830,3814,3860,3814,3860,3844,30,14,22,845840,734
1732,a1709,20160816,3860,3844,3861,3888,3861,3883,3878,39,34,60,2327040,702
1733,a1709,20160817,3883,3878,3881,3967,3872,3951,3911,73,33,148,5789740,640
1734,a1709,20160818,3951,3911,3951,3985,3946,3959,3959,48,48,138,5464700,654
1735,a1709,20160819,3959,3959,3960,3961,3902,3912,3955,-47,-4,500,19776460,638
1736,a1709,20160822,3912,3955,3897,3973,3897,3933,3949,-22,-6,52,2053580,646
1737,a1709,20160823,3933,3949,3999,3999,3900,3900,3931,-49,-18,28,1100700,638
1738,a1709,20160824,3900,3931,3900,3900,3859,3859,3873,-72,-58,98,3796420,688
1739,a1709,20160825,3859,3873,3860,3866,3825,3865,3852,-8,-21,28,1078800,686
1740,a1709,20160826,3865,3852,3850,3850,3830,3836,3837,-16,-15,32,1228100,702
1741,a1709,20160829,3836,3837,3850,3855,3835,3851,3849,14,12,24,923900,708
1742,a1709,20160830,3851,3849,3857,3877,3845,3845,3854,-4,5,42,1618800,722
1743,a1709,20160831,3845,3854,3852,3860,3776,3793,3798,-61,-56,182,6914120,772
1744,a1709,20160901,3793,3798,3785,3838,3752,3755,3775,-43,-23,216,8155480,814
1745,a1709,20160902,3755,3775,3754,3788,3737,3737,3759,-38,-16,84,3158060,824
1746,a1709,20160905,3737,3759,3746,3760,3676,3697,3719,-62,-40,280,10415200,958
1747,a1709,20160906,3697,3719,3676,3705,3676,3694,3695,-25,-24,44,1626000,956
1748,a1709,20160907,3694,3695,3708,3733,3705,3728,3719,33,24,70,2603520,962
1749,a1709,20160908,3728,3719,3731,3738,3720,3720,3733,1,14,40,1493220,946
1750,a1709,20160909,3720,3733,3733,3737,3715,3723,3724,-10,-9,134,4990640,944
1751,a1709,20160912,3723,3724,3729,3752,3721,3746,3741,22,17,118,4414620,954
1752,a1709,20160913,3746,3741,3760,3763,3731,3745,3746,4,5,50,1873300,956
1753,a1709,20160914,3745,3746,3730,3776,3710,3770,3732,24,-14,160,5972760,932
1754,a1709,20160919,3770,3732,3829,3878,3793,3869,3839,137,107,576,22115280,1130
1755,a1709,20160920,3869,3839,3869,3888,3862,3880,3874,41,35,632,24486380,1198
1756,a1709,20160921,3880,3874,3877,3889,3833,3844,3865,-30,-9,432,16697480,1374
1757,a1709,20160922,3844,3865,3825,3863,3814,3850,3845,-15,-20,156,5998220,1412
1758,a1709,20160923,3850,3845,3850,3867,3812,3824,3833,-21,-12,156,5979880,1398
1759,a1709,20160926,3824,3833,3801,3840,3801,3831,3826,-2,-7,110,4209220,1408
1760,a1709,20160927,3831,3826,3816,3828,3755,3764,3784,-62,-42,380,14381160,1436
1761,a1709,20160928,3764,3784,3751,3765,3733,3733,3746,-51,-38,264,9890600,1518
1762,a1709,20160929,3733,3746,3726,3762,3725,3751,3748,5,2,500,18741120,1274
1763,a1709,20160930,3751,3748,3737,3803,3737,3803,3769,55,21,458,17262260,966
1764,a1709,20161010,3803,3769,3785,3826,3748,3770,3770,1,1,528,19908480,966
1765,a1709,20161011,3770,3770,3754,3781,3736,3761,3756,-9,-14,1462,54925620,1334
1766,a1709,20161012,3761,3756,3741,3766,3695,3700,3718,-56,-38,904,33610760,1746
1767,a1709,20161013,3700,3718,3700,3705,3670,3674,3686,-44,-32,688,25359880,1972
1768,a1709,20161014,3674,3686,3674,3714,3672,3709,3703,23,17,948,35105920,1804
1769,a1709,20161017,3709,3703,3708,3741,3698,3729,3725,26,22,644,23992480,1850
1770,a1709,20161018,3729,3725,3722,3743,3712,3729,3726,4,1,406,15130300,2020
1771,a1709,20161019,3729,3726,3700,3731,3699,3721,3713,-5,-13,890,33050900,2282
1772,a1709,20161020,3721,3713,3701,3778,3701,3778,3750,65,37,1184,44406180,2286
1773,a1709,20161021,3778,3750,3765,3810,3744,3800,3787,50,37,1134,42944960,2064
1774,a1709,20161024,3800,3787,3788,3847,3785,3844,3815,57,28,734,28004480,2066
1775,a1709,20161025,3844,3815,3844,3877,3803,3811,3834,-4,19,774,29681640,2136
1776,a1709,20161026,3811,3834,3801,3931,3796,3924,3856,90,22,3456,133281480,1798
1777,a1709,20161027,3924,3856,3924,3961,3905,3920,3930,64,74,832,32703160,1688
1778,a1709,20161028,3920,3930,3906,3935,3897,3916,3919,-14,-11,644,25239700,1724
1779,a1709,20161031,3916,3919,3905,3930,3882,3891,3898,-28,-21,460,17931540,1744
1780,a1709,20161101,3891,3898,3871,3944,3863,3915,3923,17,25,1222,47939320,2046
1781,a1709,20161102,3915,3923,3902,3933,3853,3859,3879,-64,-44,906,35148860,2082
1782,a1709,20161103,3859,3879,3859,3892,3832,3846,3863,-33,-16,742,28663460,2082
1783,a1709,20161104,3846,3863,3841,3870,3837,3838,3856,-25,-7,352,13573200,2128
1784,a1709,20161107,3838,3856,3838,3915,3825,3900,3878,44,22,706,27379080,2082
1785,a1709,20161108,3900,3878,3892,3932,3884,3920,3902,42,24,828,32314600,2234
1786,a1709,20161109,3920,3902,3908,3942,3870,3895,3918,-7,16,874,34247060,2248
1787,a1709,20161110,3895,3918,3907,3998,3886,3977,3941,59,23,1642,64720060,2598
1788,a1709,20161111,3977,3941,3956,4082,3950,4035,4032,94,91,1574,63478900,3152
1789,a1709,20161114,4035,4032,4011,4081,3846,3856,3905,-176,-127,3614,141161740,2882
1790,a1709,20161115,3856,3905,3847,3922,3830,3836,3867,-69,-38,1408,54449220,2732
1791,a1709,20161116,3836,3867,3835,3882,3835,3865,3862,-2,-5,932,35994080,2636
1792,a1709,20161117,3865,3862,3851,3879,3851,3865,3868,3,6,560,21662100,2592
1793,a1709,20161118,3865,3868,3855,3875,3832,3855,3848,-13,-20,414,15930960,2586
1794,a1709,20161121,3855,3848,3865,3910,3845,3893,3877,45,29,792,30713640,2554
1795,a1709,20161122,3893,3877,3882,3954,3882,3941,3918,64,41,1888,73976760,2540
1796,a1709,20161123,3941,3918,3915,3990,3913,3953,3955,35,37,734,29030380,2462
1797,a1709,20161124,3953,3955,3936,4021,3932,3966,3976,11,21,1574,62593560,2442
1798,a1709,20161125,3966,3976,3943,3981,3933,3977,3962,1,-14,892,35349520,2510
1799,a1709,20161128,3977,3962,3989,4059,3936,4041,3979,79,17,4390,174707000,2934
1800,a1709,20161129,4041,3979,4020,4144,4019,4101,4098,122,119,2740,112286900,3242
1801,a1709,20161130,4101,4098,4088,4105,3992,4016,4051,-82,-47,2316,93844280,3456
1802,a1709,20161201,4016,4051,4016,4105,4014,4070,4061,19,10,826,33544980,3310
1803,a1709,20161202,4070,4061,4059,4237,4044,4208,4171,147,110,5258,219318420,4754
1804,a1709,20161205,4208,4171,4200,4266,4185,4223,4221,52,50,2718,114743460,4946
1805,a1709,20161206,4223,4221,4221,4243,4180,4205,4208,-16,-13,1172,49324980,4932
1806,a1709,20161207,4205,4208,4222,4305,4200,4266,4254,58,46,2206,93865140,5456
1807,a1709,20161208,4266,4254,4265,4274,4199,4212,4225,-42,-29,1502,63465880,5452
1808,a1709,20161209,4212,4225,4204,4211,4150,4192,4181,-33,-44,2534,105948180,5994
1809,a1709,20161212,4192,4181,4191,4245,4185,4212,4222,31,41,2010,84869180,6914
1810,a1709,20161213,4212,4222,4190,4240,4184,4222,4216,0,-6,918,38704980,6930
1811,a1709,20161214,4222,4216,4232,4248,4190,4204,4217,-12,1,978,41247200,7046
1812,a1709,20161215,4204,4217,4200,4245,4181,4227,4219,10,2,1614,68100120,6926
1813,a1709,20161216,4227,4219,4215,4363,4215,4332,4320,113,101,7396,319534560,8586
1814,a1709,20161219,4332,4320,4339,4400,4304,4335,4362,15,42,5890,256955320,10184
1815,a1709,20161220,4335,4362,4350,4350,4239,4250,4297,-112,-65,5472,235145380,11152
1816,a1709,20161221,4250,4297,4269,4349,4239,4319,4308,22,11,8164,351726680,12676
1817,a1709,20161222,4319,4308,4291,4343,4272,4274,4311,-34,3,11438,493191220,16158
1818,a1709,20161223,4274,4311,4280,4285,4192,4248,4240,-63,-71,10792,457583880,17430
1819,a1709,20161226,4248,4240,4250,4266,4035,4083,4127,-157,-113,15882,655511020,18802
1820,a1709,20161227,4083,4127,4073,4146,4072,4126,4103,-1,-24,10248,420504100,19792
1821,a1709,20161228,4126,4103,4135,4215,4122,4133,4161,30,58,6476,269488860,20422
1822,a1709,20161229,4133,4161,4138,4289,4106,4235,4218,74,57,17714,747183820,21614
1823,a1709,20161230,4235,4218,4235,4256,4173,4190,4206,-28,-12,7422,312233420,22028
1824,a1711,20160517,3723,3723,0,0,0,3752,3752,29,29,0,0,0
1825,a1711,20160518,3752,3752,0,0,0,3752,3752,0,0,0,0,0
1826,a1711,20160519,3752,3752,3826,3826,3826,3826,3826,74,74,2,76520,2
1827,a1711,20160520,3826,3826,0,0,0,3826,3826,0,0,0,0,2
1828,a1711,20160523,3826,3826,3759,3759,3759,3759,3759,-67,-67,2,75180,0
1829,a1711,20160524,3759,3759,0,0,0,3657,3657,-102,-102,0,0,0
1830,a1711,20160525,3657,3657,3630,3690,3630,3660,3660,3,3,8,292800,0
1831,a1711,20160526,3660,3660,0,0,0,3722,3722,62,62,0,0,0
1832,a1711,20160527,3722,3722,0,0,0,3731,3731,9,9,0,0,0
1833,a1711,20160530,3731,3731,0,0,0,3793,3793,62,62,0,0,0
1834,a1711,20160531,3793,3793,0,0,0,3793,3793,0,0,0,0,0
1835,a1711,20160601,3793,3793,0,0,0,3793,3793,0,0,0,0,0
1836,a1711,20160602,3793,3793,3850,3850,3850,3850,3850,57,57,2,77000,2
1837,a1711,20160603,3850,3850,0,0,0,3850,3850,0,0,0,0,2
1838,a1711,20160606,3850,3850,3826,3826,3826,3826,3826,-24,-24,2,76520,2
1839,a1711,20160607,3826,3826,0,0,0,3826,3826,0,0,0,0,2
1840,a1711,20160608,3826,3826,0,0,0,3826,3826,0,0,0,0,2
1841,a1711,20160613,3826,3826,0,0,0,3826,3826,0,0,0,0,2
1842,a1711,20160614,3826,3826,0,0,0,3826,3826,0,0,0,0,2
1843,a1711,20160615,3826,3826,0,0,0,3826,3826,0,0,0,0,2
1844,a1711,20160616,3826,3826,0,0,0,3826,3826,0,0,0,0,2
1845,a1711,20160617,3826,3826,0,0,0,3826,3826,0,0,0,0,2
1846,a1711,20160620,3826,3826,0,0,0,3852,3852,26,26,0,0,2
1847,a1711,20160621,3852,3852,0,0,0,3852,3852,0,0,0,0,2
1848,a1711,20160622,3852,3852,0,0,0,3854,3854,2,2,0,0,2
1849,a1711,20160623,3854,3854,3901,3901,3901,3901,3901,47,47,2,78020,0
1850,a1711,20160624,3901,3901,0,0,0,3881,3881,-20,-20,0,0,0
1851,a1711,20160627,3881,3881,0,0,0,3881,3881,0,0,0,0,0
1852,a1711,20160628,3881,3881,3929,3929,3929,3929,3929,48,48,2,78580,2
1853,a1711,20160629,3929,3929,3931,3931,3923,3923,3927,-6,-2,4,157080,2
1854,a1711,20160630,3923,3927,3923,3949,3923,3949,3932,22,5,6,235920,6
1855,a1711,20160701,3949,3932,0,0,0,3932,3932,0,0,0,0,6
1856,a1711,20160704,3932,3932,0,0,0,3981,3981,49,49,0,0,6
1857,a1711,20160705,3981,3981,0,0,0,3981,3981,0,0,0,0,6
1858,a1711,20160706,3981,3981,0,0,0,3961,3961,-20,-20,0,0,6
1859,a1711,20160707,3961,3961,3910,3962,3910,3962,3927,1,-34,6,235640,6
1860,a1711,20160708,3962,3927,3846,3889,3846,3889,3865,-38,-62,16,618540,10
1861,a1711,20160711,3889,3865,0,0,0,3866,3866,1,1,0,0,10
1862,a1711,20160712,3866,3866,0,0,0,3866,3866,0,0,0,0,10
1863,a1711,20160713,3866,3866,0,0,0,3904,3904,38,38,0,0,10
1864,a1711,20160714,3904,3904,3934,3960,3883,3960,3925,56,21,6,235540,10
1865,a1711,20160715,3960,3925,0,0,0,3925,3925,0,0,0,0,10
1866,a1711,20160718,3925,3925,3934,3934,3890,3890,3919,-35,-6,6,235160,10
1867,a1711,20160719,3890,3919,3947,3947,3947,3947,3947,28,28,2,78940,8
1868,a1711,20160720,3947,3947,0,0,0,3947,3947,0,0,0,0,8
1869,a1711,20160721,3947,3947,0,0,0,3921,3921,-26,-26,0,0,8
1870,a1711,20160722,3921,3921,3902,3902,3825,3825,3869,-96,-52,40,1547760,18
1871,a1711,20160725,3825,3869,3798,3798,3719,3771,3759,-98,-110,16,601540,14
1872,a1711,20160726,3771,3759,3773,3776,3746,3774,3767,15,8,8,301380,12
1873,a1711,20160727,3774,3767,0,0,0,3767,3767,0,0,0,0,12
1874,a1711,20160728,3767,3767,3827,3827,3827,3827,3827,60,60,2,76540,10
1875,a1711,20160729,3827,3827,0,0,0,3827,3827,0,0,0,0,10
1876,a1711,20160801,3827,3827,0,0,0,3827,3827,0,0,0,0,10
1877,a1711,20160802,3827,3827,0,0,0,3780,3780,-47,-47,0,0,10
1878,a1711,20160803,3780,3780,0,0,0,3770,3770,-10,-10,0,0,10
1879,a1711,20160804,3770,3770,0,0,0,3770,3770,0,0,0,0,10
1880,a1711,20160805,3770,3770,0,0,0,3770,3770,0,0,0,0,10
1881,a1711,20160808,3770,3770,0,0,0,3773,3773,3,3,0,0,10
1882,a1711,20160809,3773,3773,0,0,0,3773,3773,0,0,0,0,10
1883,a1711,20160810,3773,3773,3842,3842,3842,3842,3842,69,69,2,76840,10
1884,a1711,20160811,3842,3842,0,0,0,3842,3842,0,0,0,0,10
1885,a1711,20160812,3842,3842,3831,3831,3831,3831,3831,-11,-11,2,76620,10
1886,a1711,20160815,3831,3831,0,0,0,3831,3831,0,0,0,0,10
1887,a1711,20160816,3831,3831,0,0,0,3831,3831,0,0,0,0,10
1888,a1711,20160817,3831,3831,3928,3928,3928,3928,3928,97,97,2,78560,10
1889,a1711,20160818,3928,3928,3951,3962,3920,3962,3944,34,16,6,236660,8
1890,a1711,20160819,3962,3944,0,0,0,3944,3944,0,0,0,0,8
1891,a1711,20160822,3944,3944,3931,3931,3931,3931,3931,-13,-13,2,78620,6
1892,a1711,20160823,3931,3931,3889,3900,3889,3900,3894,-31,-37,4,155780,6
1893,a1711,20160824,3900,3894,0,0,0,3894,3894,0,0,0,0,6
1894,a1711,20160825,3894,3894,0,0,0,3894,3894,0,0,0,0,6
1895,a1711,20160826,3894,3894,0,0,0,3894,3894,0,0,0,0,6
1896,a1711,20160829,3894,3894,0,0,0,3894,3894,0,0,0,0,6
1897,a1711,20160830,3894,3894,3858,3879,3858,3879,3868,-15,-26,4,154740,6
1898,a1711,20160831,3879,3868,3757,3757,3757,3757,3757,-111,-111,2,75140,4
1899,a1711,20160901,3757,3757,0,0,0,3757,3757,0,0,0,0,4
1900,a1711,20160902,3757,3757,3821,3821,3821,3821,3821,64,64,2,76420,4
1901,a1711,20160905,3821,3821,0,0,0,3821,3821,0,0,0,0,4
1902,a1711,20160906,3821,3821,0,0,0,3797,3797,-24,-24,0,0,4
1903,a1711,20160907,3797,3797,3726,3726,3726,3726,3726,-71,-71,2,74520,4
1904,a1711,20160908,3726,3726,0,0,0,3726,3726,0,0,0,0,4
1905,a1711,20160909,3726,3726,0,0,0,3726,3726,0,0,0,0,4
1906,a1711,20160912,3726,3726,0,0,0,3726,3726,0,0,0,0,4
1907,a1711,20160913,3726,3726,0,0,0,3726,3726,0,0,0,0,4
1908,a1711,20160914,3726,3726,3726,3726,3726,3726,3726,0,0,2,74520,6
1909,a1711,20160919,3726,3726,3878,3878,3878,3878,3878,152,152,4,155120,10
1910,a1711,20160920,3878,3878,3897,3897,3897,3897,3897,19,19,2,77940,8
1911,a1711,20160921,3897,3897,3867,3896,3867,3896,3881,-1,-16,4,155260,10
1912,a1711,20160922,3896,3881,0,0,0,3881,3881,0,0,0,0,10
1913,a1711,20160923,3881,3881,0,0,0,3881,3881,0,0,0,0,10
1914,a1711,20160926,3881,3881,0,0,0,3876,3876,-5,-5,0,0,10
1915,a1711,20160927,3876,3876,0,0,0,3834,3834,-42,-42,0,0,10
1916,a1711,20160928,3834,3834,0,0,0,3796,3796,-38,-38,0,0,10
1917,a1711,20160929,3796,3796,0,0,0,3796,3796,0,0,0,0,10
1918,a1711,20160930,3796,3796,0,0,0,3817,3817,21,21,0,0,10
1919,a1711,20161010,3817,3817,0,0,0,3803,3803,-14,-14,0,0,10
1920,a1711,20161011,3803,3803,0,0,0,3803,3803,0,0,0,0,10
1921,a1711,20161012,3803,3803,0,0,0,3763,3763,-40,-40,0,0,10
1922,a1711,20161013,3763,3763,0,0,0,3732,3732,-31,-31,0,0,10
1923,a1711,20161014,3732,3732,0,0,0,3732,3732,0,0,0,0,10
1924,a1711,20161017,3732,3732,3719,3775,3719,3775,3747,43,15,4,149880,10
1925,a1711,20161018,3775,3747,0,0,0,3747,3747,0,0,0,0,10
1926,a1711,20161019,3747,3747,3770,3770,3770,3770,3770,23,23,2,75400,12
1927,a1711,20161020,3770,3770,0,0,0,3770,3770,0,0,0,0,12
1928,a1711,20161021,3770,3770,0,0,0,3781,3781,11,11,0,0,12
1929,a1711,20161024,3781,3781,3836,3836,3836,3836,3836,55,55,4,153440,8
1930,a1711,20161025,3836,3836,0,0,0,3836,3836,0,0,0,0,8
1931,a1711,20161026,3836,3836,3868,3868,3868,3868,3868,32,32,2,77360,8
1932,a1711,20161027,3868,3868,3920,3920,3917,3917,3918,49,50,4,156740,10
1933,a1711,20161028,3917,3918,0,0,0,3918,3918,0,0,0,0,10
1934,a1711,20161031,3918,3918,0,0,0,3918,3918,0,0,0,0,10
1935,a1711,20161101,3918,3918,0,0,0,3918,3918,0,0,0,0,10
1936,a1711,20161102,3918,3918,0,0,0,3899,3899,-19,-19,0,0,10
1937,a1711,20161103,3899,3899,0,0,0,3868,3868,-31,-31,0,0,10
1938,a1711,20161104,3868,3868,0,0,0,3868,3868,0,0,0,0,10
1939,a1711,20161107,3868,3868,0,0,0,3868,3868,0,0,0,0,10
1940,a1711,20161108,3868,3868,0,0,0,3890,3890,22,22,0,0,10
1941,a1711,20161109,3890,3890,0,0,0,3890,3890,0,0,0,0,10
1942,a1711,20161110,3890,3890,0,0,0,3890,3890,0,0,0,0,10
1943,a1711,20161111,3890,3890,4060,4060,4044,4044,4059,154,169,32,1298880,38
1944,a1711,20161114,4044,4059,4022,4022,3931,3931,3976,-128,-83,4,159060,36
1945,a1711,20161115,3931,3976,0,0,0,3938,3938,-38,-38,0,0,36
1946,a1711,20161116,3938,3938,0,0,0,3933,3933,-5,-5,0,0,36
1947,a1711,20161117,3933,3933,3925,3925,3846,3873,3886,-60,-47,14,544080,36
1948,a1711,20161118,3873,3886,0,0,0,3886,3886,0,0,0,0,36
1949,a1711,20161121,3886,3886,0,0,0,3887,3887,1,1,0,0,36
1950,a1711,20161122,3887,3887,0,0,0,3887,3887,0,0,0,0,36
1951,a1711,20161123,3887,3887,0,0,0,3887,3887,0,0,0,0,36
1952,a1711,20161124,3887,3887,0,0,0,3887,3887,0,0,0,0,36
1953,a1711,20161125,3887,3887,3923,3924,3893,3924,3913,37,26,44,1721820,18
1954,a1711,20161128,3924,3913,3957,3959,3946,3946,3953,33,40,10,395320,10
1955,a1711,20161129,3946,3953,0,0,0,3953,3953,0,0,0,0,10
1956,a1711,20161130,3953,3953,0,0,0,3908,3908,-45,-45,0,0,10
1957,a1711,20161201,3908,3908,0,0,0,3917,3917,9,9,0,0,10
1958,a1711,20161202,3917,3917,4112,4112,4112,4112,4112,195,195,4,164480,8
1959,a1711,20161205,4112,4112,0,0,0,4129,4129,17,17,0,0,8
1960,a1711,20161206,4129,4129,0,0,0,4129,4129,0,0,0,0,8
1961,a1711,20161207,4129,4129,4311,4311,4311,4311,4311,182,182,4,172440,6
1962,a1711,20161208,4311,4311,0,0,0,4282,4282,-29,-29,0,0,6
1963,a1711,20161209,4282,4282,0,0,0,4238,4238,-44,-44,0,0,6
1964,a1711,20161212,4238,4238,0,0,0,4238,4238,0,0,0,0,6
1965,a1711,20161213,4238,4238,0,0,0,4238,4238,0,0,0,0,6
1966,a1711,20161214,4238,4238,0,0,0,4230,4230,-8,-8,0,0,6
1967,a1711,20161215,4230,4230,0,0,0,4230,4230,0,0,0,0,6
1968,a1711,20161216,4230,4230,0,0,0,4331,4331,101,101,0,0,6
1969,a1711,20161219,4331,4331,4356,4356,4356,4356,4356,25,25,2,87120,6
1970,a1711,20161220,4356,4356,0,0,0,4292,4292,-64,-64,0,0,6
1971,a1711,20161221,4292,4292,0,0,0,4292,4292,0,0,0,0,6
1972,a1711,20161222,4292,4292,0,0,0,4292,4292,0,0,0,0,6
1973,a1711,20161223,4292,4292,0,0,0,4292,4292,0,0,0,0,6
1974,a1711,20161226,4292,4292,4078,4101,4078,4100,4093,-192,-199,6,245580,4
1975,a1711,20161227,4100,4093,4086,4086,4086,4086,4086,-7,-7,2,81720,4
1976,a1711,20161228,4086,4086,0,0,0,4093,4093,7,7,0,0,4
1977,a1711,20161229,4093,4093,0,0,0,4149,4149,56,56,0,0,4
1978,a1711,20161230,4149,4149,0,0,0,4149,4149,0,0,0,0,4
1979,a1801,20160715,3932,3932,3899,3960,3899,3960,3938,28,6,10,393880,8
1980,a1801,20160718,3960,3938,3920,3955,3915,3925,3928,-13,-10,8,314300,8
1981,a1801,20160719,3925,3928,3925,3965,3925,3965,3945,37,17,4,157800,8
1982,a1801,20160720,3965,3945,3865,3920,3865,3920,3896,-25,-49,6,233800,10
1983,a1801,20160721,3920,3896,3885,3915,3885,3915,3900,19,4,4,156000,10
1984,a1801,20160722,3915,3900,3887,3887,3836,3860,3868,-40,-32,20,773660,24
1985,a1801,20160725,3860,3868,0,0,0,3852,3852,-16,-16,0,0,24
1986,a1801,20160726,3852,3852,3837,3858,3833,3833,3842,-19,-10,6,230560,24
1987,a1801,20160727,3833,3842,0,0,0,3842,3842,0,0,0,0,24
1988,a1801,20160728,3842,3842,3835,3845,3835,3845,3840,3,-2,4,153600,24
1989,a1801,20160729,3845,3840,3820,3820,3820,3820,3820,-20,-20,2,76400,24
1990,a1801,20160801,3820,3820,3800,3807,3800,3806,3804,-14,-16,6,228260,20
1991,a1801,20160802,3806,3804,0,0,0,3804,3804,0,0,0,0,20
1992,a1801,20160803,3804,3804,0,0,0,3804,3804,0,0,0,0,20
1993,a1801,20160804,3804,3804,0,0,0,3804,3804,0,0,0,0,20
1994,a1801,20160805,3804,3804,0,0,0,3823,3823,19,19,0,0,20
1995,a1801,20160808,3823,3823,3867,3867,3813,3850,3843,27,20,6,230600,20
1996,a1801,20160809,3850,3843,0,0,0,3843,3843,0,0,0,0,20
1997,a1801,20160810,3843,3843,3900,3900,3900,3900,3900,57,57,2,78000,20
1998,a1801,20160811,3900,3900,3865,3865,3865,3865,3865,-35,-35,2,77300,22
1999,a1801,20160812,3865,3865,3855,3855,3842,3855,3851,-10,-14,28,1078480,40
2000,a1801,20160815,3855,3851,3833,3877,3824,3877,3845,26,-6,8,307600,46
2001,a1801,20160816,3877,3845,3890,3890,3890,3890,3890,45,45,2,77800,48
2002,a1801,20160817,3890,3890,3911,3954,3911,3954,3928,64,38,6,235720,50
2003,a1801,20160818,3954,3928,3977,3990,3960,3961,3979,33,51,14,557060,56
2004,a1801,20160819,3961,3979,3950,3950,3919,3919,3933,-60,-46,12,472020,58
2005,a1801,20160822,3919,3933,3910,3978,3910,3955,3941,22,8,14,551800,52
2006,a1801,20160823,3955,3941,3950,3950,3950,3950,3950,9,9,2,79000,54
2007,a1801,20160824,3950,3950,3904,3904,3863,3871,3889,-79,-61,50,1944860,58
2008,a1801,20160825,3871,3889,3899,3899,3870,3870,3879,-19,-10,8,310380,62
2009,a1801,20160826,3870,3879,3866,3866,3853,3853,3859,-26,-20,4,154380,66
2010,a1801,20160829,3853,3859,3860,3885,3860,3885,3872,26,13,4,154900,66
2011,a1801,20160830,3885,3872,3872,3872,3862,3862,3867,-10,-5,4,154680,68
2012,a1801,20160831,3862,3867,3865,3874,3818,3818,3836,-49,-31,30,1151020,86
2013,a1801,20160901,3818,3836,3830,3830,3798,3798,3806,-38,-30,26,989560,106
2014,a1801,20160902,3798,3806,3792,3810,3769,3769,3794,-37,-12,42,1593500,104
2015,a1801,20160905,3769,3794,3772,3794,3745,3748,3760,-46,-34,52,1955600,126
2016,a1801,20160906,3748,3760,3741,3748,3740,3748,3742,-12,-18,14,523880,124
2017,a1801,20160907,3748,3742,3750,3766,3746,3764,3754,22,12,24,901020,134
2018,a1801,20160908,3764,3754,3770,3773,3735,3755,3762,1,8,16,601920,126
2019,a1801,20160909,3755,3762,3756,3756,3750,3751,3752,-11,-10,10,375280,126
2020,a1801,20160912,3751,3752,3784,3788,3750,3788,3771,36,19,32,1206840,114
2021,a1801,20160913,3788,3771,3786,3788,3762,3770,3774,-1,3,20,754980,112
2022,a1801,20160914,3770,3774,3757,3804,3745,3804,3767,30,-7,30,1130160,114
2023,a1801,20160919,3804,3767,3819,3911,3819,3900,3873,133,106,118,4570200,180
2024,a1801,20160920,3900,3873,3907,3921,3894,3919,3907,46,34,172,6721140,278
2025,a1801,20160921,3919,3907,3885,3911,3856,3870,3906,-37,-1,142,5546980,396
2026,a1801,20160922,3870,3906,3873,3899,3859,3884,3880,-22,-26,76,2948960,452
2027,a1801,20160923,3884,3880,3898,3898,3822,3854,3863,-26,-17,52,2009100,458
2028,a1801,20160926,3854,3863,3856,3884,3848,3859,3867,-4,4,26,1005520,460
2029,a1801,20160927,3859,3867,3855,3855,3796,3796,3835,-71,-32,50,1917860,474
2030,a1801,20160928,3796,3835,3790,3806,3780,3781,3792,-54,-43,50,1896480,478
2031,a1801,20160929,3781,3792,3780,3813,3779,3810,3797,18,5,26,987240,468
2032,a1801,20160930,3810,3797,3797,3877,3785,3847,3812,50,15,42,1601160,474
2033,a1801,20161010,3847,3812,3754,3821,3754,3821,3804,9,-8,30,1141240,460
2034,a1801,20161011,3821,3804,3800,3808,3775,3791,3788,-13,-16,204,7729400,364
2035,a1801,20161012,3791,3788,3799,3799,3749,3759,3768,-29,-20,64,2412060,408
2036,a1801,20161013,3759,3768,3741,3754,3715,3716,3731,-52,-37,134,4999860,414
2037,a1801,20161014,3716,3731,3741,3758,3736,3756,3747,25,16,64,2398560,426
2038,a1801,20161017,3756,3747,3763,3792,3760,3791,3778,44,31,52,1965060,454
2039,a1801,20161018,3791,3778,3794,3796,3730,3782,3780,4,2,78,2948560,476
2040,a1801,20161019,3782,3780,3786,3788,3760,3776,3773,-4,-7,72,2716980,486
2041,a1801,20161020,3776,3773,3792,3838,3782,3835,3817,62,44,192,7329720,568
2042,a1801,20161021,3835,3817,3835,3871,3810,3842,3847,25,30,422,16237360,760
2043,a1801,20161024,3842,3847,3841,3888,3829,3888,3852,41,5,172,6625580,736
2044,a1801,20161025,3888,3852,3900,3935,3871,3882,3903,30,51,274,10694860,952
2045,a1801,20161026,3882,3903,3881,3952,3863,3951,3916,48,13,442,17308920,910
2046,a1801,20161027,3951,3916,3940,3974,3917,3938,3944,22,28,472,18616580,1158
2047,a1801,20161028,3938,3944,3925,3949,3904,3949,3931,5,-13,150,5897940,1264
2048,a1801,20161031,3949,3931,3940,3950,3888,3908,3917,-23,-14,144,5641760,1332
2049,a1801,20161101,3908,3917,3892,3930,3892,3908,3915,-9,-2,640,25059000,1824
2050,a1801,20161102,3908,3915,3923,3929,3866,3866,3887,-49,-28,162,6298440,1818
2051,a1801,20161103,3866,3887,3895,3898,3838,3862,3861,-25,-26,194,7491580,1846
2052,a1801,20161104,3862,3861,3864,3874,3849,3849,3860,-12,-1,90,3474500,1836
2053,a1801,20161107,3849,3860,3839,3907,3839,3892,3897,32,37,328,12782240,2038
2054,a1801,20161108,3892,3897,3899,3926,3892,3908,3903,11,6,390,15223120,2258
2055,a1801,20161109,3908,3903,3910,3918,3874,3891,3902,-12,-1,542,21151720,2254
2056,a1801,20161110,3891,3902,3907,3947,3890,3930,3918,28,16,1266,49613040,2826
2057,a1801,20161111,3930,3918,3918,4051,3918,4005,3986,87,68,1800,71761720,3932
2058,a1801,20161114,4005,3986,4014,4029,3840,3869,3930,-117,-56,1856,72952800,3182
2059,a1801,20161115,3869,3930,3870,3917,3836,3850,3873,-80,-57,352,13636080,3150
2060,a1801,20161116,3850,3873,3860,3884,3860,3880,3868,7,-5,290,11218380,3110
2061,a1801,20161117,3880,3868,3886,3887,3863,3881,3880,13,12,154,5975660,3130
2062,a1801,20161118,3881,3880,3884,3884,3851,3865,3867,-15,-13,76,2938940,3144
2063,a1801,20161121,3865,3867,3875,3900,3850,3894,3869,27,2,348,13466320,3154
2064,a1801,20161122,3894,3869,3907,3926,3896,3912,3916,43,47,1556,60934960,4174
2065,a1801,20161123,3912,3916,3825,3975,3825,3929,3911,13,-5,1434,56096260,4782
2066,a1801,20161124,3929,3911,3938,4005,3921,3957,3961,46,50,596,23612340,4894
2067,a1801,20161125,3957,3961,3968,3977,3933,3954,3958,-7,-3,276,10924740,4930
2068,a1801,20161128,3954,3958,3977,4018,3919,4008,3964,50,6,2378,94275020,4822
2069,a1801,20161129,4008,3964,4001,4108,3980,4084,4064,120,100,1748,71049900,5310
2070,a1801,20161130,4084,4064,4061,4078,3964,4001,4019,-63,-45,992,39871540,5562
2071,a1801,20161201,4001,4019,4026,4072,4008,4053,4038,34,19,1060,42808740,5534
2072,a1801,20161202,4053,4038,4068,4219,4000,4181,4082,143,44,4238,173011420,7460
2073,a1801,20161205,4181,4082,4196,4216,4130,4198,4176,116,94,1934,80774160,8004
2074,a1801,20161206,4198,4176,4191,4204,4160,4171,4179,-5,3,466,19474240,8104
2075,a1801,20161207,4171,4179,4188,4283,4158,4236,4206,57,27,1546,65031980,8642
2076,a1801,20161208,4236,4206,4218,4243,4147,4151,4186,-55,-20,640,26792160,8722
2077,a1801,20161209,4151,4186,4160,4161,4096,4137,4125,-49,-61,1850,76321200,9258
2078,a1801,20161212,4137,4125,4142,4189,4136,4157,4165,32,40,1778,74054540,9982
2079,a1801,20161213,4157,4165,4157,4185,4141,4170,4168,5,3,612,25509820,9976
2080,a1801,20161214,4170,4168,4179,4188,4135,4153,4158,-15,-10,528,21958900,9950
2081,a1801,20161215,4153,4158,4137,4189,4128,4173,4163,15,5,524,21818480,9942
2082,a1801,20161216,4173,4163,4159,4300,4159,4279,4250,116,87,1806,76770800,10136
2083,a1801,20161219,4279,4250,4268,4337,4266,4288,4310,38,60,1268,54654440,10554
2084,a1801,20161220,4288,4310,4278,4289,4197,4212,4238,-98,-72,804,34080440,10480
2085,a1801,20161221,4212,4238,4202,4289,4202,4240,4263,2,25,1110,47327840,10924
2086,a1801,20161222,4240,4263,4259,4276,4228,4228,4257,-35,-6,1612,68634680,11030
2087,a1801,20161223,4228,4257,4222,4237,4155,4203,4184,-54,-73,1186,49630060,10742
2088,a1801,20161226,4203,4184,4203,4206,4050,4060,4094,-124,-90,2956,121033380,9448
2089,a1801,20161227,4060,4094,4074,4119,4050,4096,4070,2,-24,2898,117966440,9618
2090,a1801,20161228,4096,4070,4115,4154,4075,4098,4112,28,42,3482,143204200,9914
2091,a1801,20161229,4098,4112,4112,4230,4062,4172,4153,60,41,5614,233175220,10288
2092,a1801,20161230,4172,4153,4173,4198,4111,4140,4149,-13,-4,3792,157350500,10906
2093,a1803,20160919,3754,3754,0,0,0,3859,3859,105,105,0,0,0
2094,a1803,20160920,3859,3859,0,0,0,3859,3859,0,0,0,0,0
2095,a1803,20160921,3859,3859,0,0,0,3859,3859,0,0,0,0,0
2096,a1803,20160922,3859,3859,0,0,0,3859,3859,0,0,0,0,0
2097,a1803,20160923,3859,3859,0,0,0,3859,3859,0,0,0,0,0
2098,a1803,20160926,3859,3859,0,0,0,3859,3859,0,0,0,0,0
2099,a1803,20160927,3859,3859,0,0,0,3840,3840,-19,-19,0,0,0
2100,a1803,20160928,3840,3840,0,0,0,3830,3830,-10,-10,0,0,0
2101,a1803,20160929,3830,3830,0,0,0,3825,3825,-5,-5,0,0,0
2102,a1803,20160930,3825,3825,0,0,0,3840,3840,15,15,0,0,0
2103,a1803,20161010,3840,3840,0,0,0,3832,3832,-8,-8,0,0,0
2104,a1803,20161011,3832,3832,0,0,0,3832,3832,0,0,0,0,0
2105,a1803,20161012,3832,3832,0,0,0,3832,3832,0,0,0,0,0
2106,a1803,20161013,3832,3832,0,0,0,3832,3832,0,0,0,0,0
2107,a1803,20161014,3832,3832,0,0,0,3775,3775,-57,-57,0,0,0
2108,a1803,20161017,3775,3775,0,0,0,3806,3806,31,31,0,0,0
2109,a1803,20161018,3806,3806,0,0,0,3806,3806,0,0,0,0,0
2110,a1803,20161019,3806,3806,0,0,0,3806,3806,0,0,0,0,0
2111,a1803,20161020,3806,3806,0,0,0,3806,3806,0,0,0,0,0
2112,a1803,20161021,3806,3806,0,0,0,3806,3806,0,0,0,0,0
2113,a1803,20161024,3806,3806,0,0,0,3859,3859,53,53,0,0,0
2114,a1803,20161025,3859,3859,0,0,0,3859,3859,0,0,0,0,0
2115,a1803,20161026,3859,3859,0,0,0,3930,3930,71,71,0,0,0
2116,a1803,20161027,3930,3930,0,0,0,3930,3930,0,0,0,0,0
2117,a1803,20161028,3930,3930,0,0,0,3930,3930,0,0,0,0,0
2118,a1803,20161031,3930,3930,0,0,0,3930,3930,0,0,0,0,0
2119,a1803,20161101,3930,3930,0,0,0,3930,3930,0,0,0,0,0
2120,a1803,20161102,3930,3930,0,0,0,3914,3914,-16,-16,0,0,0
2121,a1803,20161103,3914,3914,0,0,0,3914,3914,0,0,0,0,0
2122,a1803,20161104,3914,3914,0,0,0,3914,3914,0,0,0,0,0
2123,a1803,20161107,3914,3914,0,0,0,3914,3914,0,0,0,0,0
2124,a1803,20161108,3914,3914,0,0,0,3914,3914,0,0,0,0,0
2125,a1803,20161109,3914,3914,0,0,0,3914,3914,0,0,0,0,0
2126,a1803,20161110,3914,3914,0,0,0,3914,3914,0,0,0,0,0
2127,a1803,20161111,3914,3914,4133,4133,4133,4133,4133,219,219,2,82660,2
2128,a1803,20161114,4133,4133,3927,3940,3927,3927,3929,-206,-204,18,707220,10
2129,a1803,20161115,3927,3929,3931,3931,3910,3910,3924,-19,-5,6,235440,12
2130,a1803,20161116,3910,3924,3906,3906,3906,3906,3906,-18,-18,4,156240,12
2131,a1803,20161117,3906,3906,0,0,0,3906,3906,0,0,0,0,12
2132,a1803,20161118,3906,3906,0,0,0,3905,3905,-1,-1,0,0,12
2133,a1803,20161121,3905,3905,3880,3931,3880,3931,3905,26,0,4,156220,12
2134,a1803,20161122,3931,3905,3920,3920,3920,3920,3920,15,15,2,78400,10
2135,a1803,20161123,3920,3920,0,0,0,3920,3920,0,0,0,0,10
2136,a1803,20161124,3920,3920,0,0,0,3971,3971,51,51,0,0,10
2137,a1803,20161125,3971,3971,0,0,0,3971,3971,0,0,0,0,10
2138,a1803,20161128,3971,3971,4044,4044,4044,4044,4044,73,73,2,80880,12
2139,a1803,20161129,4044,4044,0,0,0,4044,4044,0,0,0,0,12
2140,a1803,20161130,4044,4044,0,0,0,4044,4044,0,0,0,0,12
2141,a1803,20161201,4044,4044,0,0,0,4044,4044,0,0,0,0,12
2142,a1803,20161202,4044,4044,0,0,0,4044,4044,0,0,0,0,12
2143,a1803,20161205,4044,4044,0,0,0,4044,4044,0,0,0,0,12
2144,a1803,20161206,4044,4044,0,0,0,4044,4044,0,0,0,0,12
2145,a1803,20161207,4044,4044,0,0,0,4070,4070,26,26,0,0,12
2146,a1803,20161208,4070,4070,0,0,0,4051,4051,-19,-19,0,0,12
2147,a1803,20161209,4051,4051,0,0,0,4130,4130,79,79,0,0,12
2148,a1803,20161212,4130,4130,0,0,0,4142,4142,12,12,0,0,12
2149,a1803,20161213,4142,4142,0,0,0,4142,4142,0,0,0,0,12
2150,a1803,20161214,4142,4142,0,0,0,4142,4142,0,0,0,0,12
2151,a1803,20161215,4142,4142,0,0,0,4146,4146,4,4,0,0,12
2152,a1803,20161216,4146,4146,4257,4257,4257,4257,4257,111,111,4,170280,12
2153,a1803,20161219,4257,4257,4340,4340,4340,4340,4340,83,83,2,86800,12
2154,a1803,20161220,4340,4340,4242,4242,4242,4242,4242,-98,-98,2,84840,10
2155,a1803,20161221,4242,4242,0,0,0,4267,4267,25,25,0,0,10
2156,a1803,20161222,4267,4267,0,0,0,4267,4267,0,0,0,0,10
2157,a1803,20161223,4267,4267,0,0,0,4267,4267,0,0,0,0,10
2158,a1803,20161226,4267,4267,0,0,0,4176,4176,-91,-91,0,0,10
2159,a1803,20161227,4176,4176,0,0,0,4176,4176,0,0,0,0,10
2160,a1803,20161228,4176,4176,0,0,0,4176,4176,0,0,0,0,10
2161,a1803,20161229,4176,4176,0,0,0,4217,4217,41,41,0,0,10
2162,a1803,20161230,4217,4217,0,0,0,4217,4217,0,0,0,0,10
2163,a1805,20161115,3987,3987,3945,3945,3915,3915,3930,-72,-57,4,157200,4
2164,a1805,20161116,3915,3930,0,0,0,3930,3930,0,0,0,0,4
2165,a1805,20161117,3930,3930,0,0,0,3930,3930,0,0,0,0,4
2166,a1805,20161118,3930,3930,0,0,0,3918,3918,-12,-12,0,0,4
2167,a1805,20161121,3918,3918,0,0,0,3918,3918,0,0,0,0,4
2168,a1805,20161122,3918,3918,3989,3989,3980,3980,3984,62,66,6,239060,10
2169,a1805,20161123,3980,3984,3965,3977,3943,3943,3961,-41,-23,12,475420,8
2170,a1805,20161124,3943,3961,4041,4043,4041,4043,4041,82,80,6,242500,10
2171,a1805,20161125,4043,4041,4006,4006,4006,4006,4006,-35,-35,2,80120,10
2172,a1805,20161128,4006,4006,4017,4107,3988,4055,4069,49,63,38,1546360,14
2173,a1805,20161129,4055,4069,4067,4155,4067,4116,4116,47,47,16,658600,20
2174,a1805,20161130,4116,4116,4119,4126,4079,4079,4112,-37,-4,12,493520,26
2175,a1805,20161201,4079,4112,4120,4149,4071,4120,4118,8,6,62,2553340,76
2176,a1805,20161202,4120,4118,4169,4252,4100,4252,4145,134,27,80,3316700,40
2177,a1805,20161205,4252,4145,4248,4261,4190,4221,4221,76,76,32,1350800,40
2178,a1805,20161206,4221,4221,4270,4270,4211,4223,4234,2,13,6,254080,46
2179,a1805,20161207,4223,4234,4184,4300,4184,4300,4234,66,0,16,677520,44
2180,a1805,20161208,4300,4234,4291,4291,4227,4230,4241,-4,7,10,424100,48
2181,a1805,20161209,4230,4241,4180,4187,4164,4164,4177,-77,-64,6,250620,46
2182,a1805,20161212,4164,4177,4234,4234,4234,4234,4234,57,57,10,423400,52
2183,a1805,20161213,4234,4234,4223,4223,4198,4198,4206,-36,-28,6,252400,54
2184,a1805,20161214,4198,4206,4197,4219,4197,4219,4208,13,2,4,168320,54
2185,a1805,20161215,4219,4208,4197,4197,4197,4197,4197,-11,-11,2,83940,52
2186,a1805,20161216,4197,4197,4269,4330,4246,4320,4300,123,103,44,1892300,72
2187,a1805,20161219,4320,4300,4304,4351,4304,4327,4328,27,28,36,1558260,78
2188,a1805,20161220,4327,4328,4285,4285,4252,4270,4274,-58,-54,68,2906840,96
2189,a1805,20161221,4270,4274,4317,4338,4301,4301,4316,27,42,22,949660,108
2190,a1805,20161222,4301,4316,4304,4304,4269,4284,4290,-32,-26,20,858020,106
2191,a1805,20161223,4284,4290,4266,4266,4196,4230,4218,-60,-72,14,590600,104
2192,a1805,20161226,4230,4218,4170,4205,4103,4103,4168,-115,-50,20,833620,88
2193,a1805,20161227,4103,4168,4126,4160,4100,4160,4127,-8,-41,32,1320900,80
2194,a1805,20161228,4160,4127,4155,4199,4130,4130,4167,3,40,20,833500,84
2195,a1805,20161229,4130,4167,4141,4206,4141,4206,4174,39,7,16,667900,84
2196,a1805,20161230,4206,4174,4238,4239,4185,4192,4214,18,40,24,1011360,84
